hurriedly -- поспешно !NEW!
hurry -- спешить, торопиться, спешка
hurt -- рана, болеть, причинить боль, повредить
hurts -- болеет, причиняет боль, повреждает (от hurt)
husband -- муж
hush -- водворять тишину
hut -- хижина
hybrid -- Гибрид (TR!)
hybrids -- Гибриды (TR!)
hygienic -- гигиенический
hypothesis -- Гипотеза (TR!)
hysteria -- истерия
hysterical -- истерический
I -- я
ice -- лед
icebox -- холодильник (морозильник) (не fridge)
icicle -- сосулька
icy -- ледяной
idea -- идея, мысль
ideal -- идеал, идеальный
identical -- тождественный
identification -- отождествление
identifier -- Идентификатор (TR!)
identifiers -- Идентификаторы (TR!)
identify -- опознавать, распознавать; устанавливать личность
idiot -- идиот
idle -- бесполезный
if -- если
ignition -- зажигание, воспламенение
ignorance -- незнание, невежество
ignorant -- невежественный, неосведомленный, несведущий
ignore -- игнорировать
ill -- больной
illegal -- нелегальный
illiterate -- неграмотный
illness -- болезнь
illuminate -- освещать
illuminated -- Освещенный (TR!)
illumination -- освещение
illusion -- иллюзия
illustration -- Иллюстрация (TR!)
image -- изображение, образ, имидж
imagination -- воображение
imagine -- думать, воображать
imitate -- подражать
imitation -- подражание, имитация
immediate -- непосредственный
immediately -- немедленно
immense -- громадный, необъятный
immensely -- чрезвычайно i-
immersed -- Погруженный (TR!)
imminent -- надвигающийся
immortal -- бессмертный
impact -- удар (не stroke)
impatience -- нетерпение
impatient -- нетерпеливый
impatiently -- нетерпеливо
impediment -- препятствие
impenetrable -- непроницаемый
imperative -- повелительное наклонение (грам.)
imperfect -- несовершенный
imperial -- Имперский (TR!)
impertinence -- дерзость
implement -- выполнять
implementation -- Выполнение (TR!)
implemented -- Осуществленный (TR!)
implied -- подразумеваемый (i-)
impolite -- невежливый, неучтивый
import -- импорт, ввоз
importance -- важность
important -- важный
impose -- налагать
impossible -- невозможный
impostor -- самозванец, плут
impress -- производить впечатление
impression -- впечатление
impressive -- впечатляющий -ve
imprison -- заключать в тюрьму
improbable -- невероятный
improve -- улучшать
improved -- улучшил (от improve)
improvement -- улучшение
improvements -- Усовершенствования (TR!)
impulse -- побуждение, порыв
impure -- нечистый, грязный, с примесью
in -- в
inability -- неспособность
inaccessible -- недоступный
incessant -- непрерывный, вечный
inch -- дюйм
inches -- Дюймы (TR!)
incident -- инцидент
incidentally -- между прочим
inclination -- склонность
incline -- склонять
inclined -- наклонный
include -- включать
included -- включенный (от include)
including -- включая
inclusion -- включение
income -- доход, заработок
incomprehensible -- непонятный, непостижимый i-
inconsistent -- непоследовательный
inconvenient -- неудобный
incorrect -- неверный, неправильный
increase -- рост
increasing -- возрастающий
increasingly -- все больше и больше
incredible -- невероятно
incur -- подвергаться
indebted -- обязанный
indeed -- неужели, действительно (не really)
indefinite -- неопределенный, неограниченный
independence -- независимость
independent -- независимый
independently -- независимо
index -- индекс, указатель, показатель
indexes -- Индексы (TR!)
indians -- Индусы(индейцы) (TR!)
indicate -- показывать, указывать
indices -- Индексы (не indexes) (TR!)
indifference -- безразличие
indifferent -- безразличный
indigenous -- местный
indigestion -- несварение, расстройство
indignant -- негодующий, возмущенный
indignation -- негодование, возмущение
indirect -- косвенный
individual -- личность, индивидуальный
indolent -- ленивый, праздный, безболезненный
indoors -- в помещении
induce -- убеждать
induced -- Вынужденный(вызванный) (TR!)
industrial -- промышленный
industrious -- трудолюбивый, прилежный (не hardworking)
industry -- промышленность
ineffective -- неэффективный
inevitable -- неизбежный
infant -- младенец
infer -- заключать, делать вывод
inferior -- худший, плохой
infinite -- безграничный, бесконечный
infinitely -- бесконечно
inflected -- Склоняемый (TR!)
inflection -- Сгибание (TR!)
inflict -- наносить удар
influence -- влияние, влиять
influenced -- влиял (от influence)
info -- Информация (TR!)
inform -- сообщать
information -- информация
informed -- осведомленный
informs -- Сообщает (TR!)
inga -- Инга (TR!)
ingenious -- изобретательный, остроумный, находчивый
ingratitude -- неблагодарность
ingredient -- составная часть
inhabit -- жить, обитать
inhabitant -- житель
inhabitants -- Жители (TR!)
inhabited -- Населенный *n- (TR!)
inhale -- вдыхать
inherent -- неотъемлемый, присущий, свойственный (не Integral)
inherit -- (у)наследовать
inheritance -- наследство
inherited -- Унаследованный (TR!)
initial -- начальный, первоначальный
initially -- вначале i-
initiate -- начинать (не commence)
inject -- впрыскивать
injunction -- предписание
injure -- ушибиться -e
injured -- поврежденный i-
injury -- телесное повреждение
injustice -- несправедливость
ink -- чернила
inland -- внутренний
inn -- гостиница, постоялый двор
inner -- внутренний
innocence -- невинность, невиновность
innocent -- наивный, невинный
innumerable -- бесчисленный
input -- Вход (TR!)
inquire -- спрашивать, узнавать
inquired -- осведомлённый (не informed) !NEW!
inquiries -- справочное (от inquiry)
inquiry -- расспросы, наведение справок
inquisitive -- любопытный
insane -- душевнобольной, ненормальный
inscription -- надпись
insect -- насекомое
insects -- Насекомые (TR!)
insecure -- ненадежный, небезопасный (insecure)
insert -- вставлять, помещать (в газете)
inside -- внутрь, внутри
insignificant -- незначительный, ничтожный
insist -- настаивать
insolent -- наглый, дерзкий, оскорбительный
inspect -- осматривать, инспектировать
inspection -- осмотр
inspector -- контролер, инспектор i-
inspiration -- вдохновение
inspired -- Вдохновленный (TR!)
install -- водворять, устраивать, устанавливать
installation -- Установка (TR!)
installed -- Установленный (TR!)
installer -- Монтажник (TR!)
installing -- Монтаж -ing (TR!)
installs -- Устанавливает (TR!)
instance -- пример
instances -- Случаи *n- (TR!)
instant -- мгновение
instantly -- немедленно
instead -- вместо, взамен
instinct -- инстинкт
instinctive -- инстинктивный
institution -- учреждение
instruct -- инструктировать
instruction -- инструкция
instructor -- инструктор
instrument -- инструмент
insufficient -- недостаточный
insult -- оскорбление
insurance -- страхование, страховка
intake -- поглощение
integer -- Целое число (TR!)
integral -- неотъемлемый
intellectual -- интеллигент
intelligence -- интеллект
intelligent -- умный
intend -- намереваться
intended -- предполагаемый i-
intense -- интенсивный, напряженный
intent -- намерение, цель i-
intention -- намерение, замысел
intentional -- умышленный
intentions -- Намерения (TR!)
intently -- внимательно !NEW!
interbase -- Межоснова (TR!)
intercept -- перехватывать
intercourse -- общение
interdependent -- взаимозависимый
interest -- интересовать, заинтересовывать
interested -- заинтересованный, интересующийся (от interest)
interesting -- интересный
interface -- Интерфейс (TR!)
interfere -- мешать
interference -- вмешательство
interfering -- Вмешательство -ing (TR!)
interior -- внутренний (не internal)
intermediate -- Промежуточное звено (TR!)
internal -- внутренний
international -- международный
interposed -- Вставленный (TR!)
interpret -- интерпретировать, переводить(устно) i-
interrupt -- прерывать, мешать
interruption -- прерывание
interval -- антракт, промежуток
intervals -- Интервалы (TR!)
intervention -- посредничество
interview -- встреча, беседа
intimate -- глубокий, интимный
intimidate -- пугать, запугивать
into -- в
intolerable -- невыносимый, нестерпимый
intricate -- запутанный (не entangled)
intrigue -- интрига
introduce -- предстaвлять, знакомить
introduction -- введение
intrude -- вторгаться, вмешиваться, навязываться
invade -- вторгаться
invader -- захватчик
invalid -- недействительный (не Illegal)
invaluable -- неоценимый
invariably -- неизменно
invent -- изобретать, изобрести
invention -- выдумка, изобретательность
inventor -- изобретатель
inventory -- опись
invest -- вкладывать, помещать (капитал)
investigate -- исследовать
investigation -- исследование
investigator -- исследователь
invisible -- невидимый
invitation -- приглашение
invitations -- приглашения (от invitation)
invite -- приглашать
invited -- пригласил, приглашенный (от invite)
involuntary -- невольный
involve -- втягивать, вовлекать
involved -- сложный
inward -- внутрь
irene -- Ирэн (TR!)
iron -- железо, утюг
ironic -- иронический
ironical -- иронический
irregular -- неправильный
irresistible -- непреодолимый
irresolute -- нерешительный
irresponsibility -- безответственность
irritation -- раздражение
is -- есть (от be)
isabella -- Изабелла (TR!)
island -- остров
isle -- остров(ок)
iso -- Международная организация по стандартизации (TR!)
isobel -- Исобел (TR!)
isolation -- изоляция
issue -- выпуск, издание, выпускать
issued -- Выпущенный (TR!)
issues -- Проблемы(выпуски) (TR!)
it -- это, он, она (для предметов и животных)
italian -- Итальянец (TR!)
italy -- Италия (TR!)
item -- вещь, предмет
its -- его, ее (от it)
itself -- себя, себе
ivan -- Иван (TR!)
ivory -- слоновая кость
ivy -- плющ
jack -- домкрат
jackal -- шакал
jacket -- куртка
jackson -- Джэксон (TR!)
jail -- тюрьма
jake -- Джейк (TR!)
jam -- варенье, джем
james -- Джеймс (TR!)
jan -- Январь (TR!)
January -- январь
jar -- ссора
jaw -- челюсть
jaws -- Челюсти (TR!)
jazz -- джаз
jealous -- ревнивый
jealousy -- ревность
jean -- Хлопчатобумажная ткань (TR!)
jeanne -- Джин (TR!)
jeans -- джинсы
jeer -- насмешка *e-
jeff -- Джеф (TR!)
jelly -- желе
jenny -- Дженни (TR!)
jerk -- резкий толчок, подергивание; резко толкать, дергать
jersey -- джемпер (-.....s....-)
jerusalem -- Иерусалим (TR!)
jessamy -- Джессами (TR!)
jessie -- Джесси (TR!)
jest -- шутка; шутить, высмеивать (не joke)
jet -- струя (воды, пара, газа)
jew -- Еврей (TR!)
jewel -- драгоценность
jeweller -- ювелир
jewellery -- ювелирные изделия
jewels -- драгоценности
jill -- Джилл (TR!)
jim -- Джим (TR!)
jo -- Джо (TR!)
joan -- Джоан (TR!)
job -- работа
jobs -- работы (от job)
joe -- кофе !NEW!
join -- соединяться
joining -- соединение
joint -- совместный, объединенный (j-)
joke -- шутка, шутить
joking -- шутка, шутящий (от joke)
jolly -- очень, веселый
jonas -- Джонас (TR!)
joseph -- Джозеф (TR!)
josephine -- Джозефина (TR!)
josie -- Джоси (TR!)
journal -- журнал j-
journey -- путешествие
joy -- радость
joyful -- радостный, довольный
joyfully -- Радостно *o- (TR!)
judge -- судья
judged -- Оцененный *u- (не valued) (TR!)
judgement -- приговор, суждение
judgment -- Суждение (TR!)
jug -- кувшин
juice -- сок
juicy -- сочный, дождливый
July -- июль
jumble -- толкаться
jump -- прыгать
jumped -- прыгал(а) (от jump)
jumper -- джемпер
June -- июнь
jungle -- джунгли
junior -- младший
junk -- рухлядь !NEW!
jury -- присяжные, жюри
just -- только, всего лишь, справедливый
justice -- справедливость
justin -- Джастин (TR!)
justly -- справедливо
juvenile -- юноша, подросток *u-
kalgan -- Калган (TR!)
kate -- Кейт (TR!)
kazan -- Казань (TR!)
keel -- киль
keen -- страстный
keep -- (со)держать, сохранять
keeper -- хранитель, смотритель, сторож
keeping -- хранение, содержание, согласие (k...ing)
kennel -- (собачья) конура, собачий питомник
kenneth -- Кеннет (TR!)
kept -- заставил (от keep)
kerb -- обочина
kernel -- ядро, зерно
kettle -- чайник
key -- ключ
keyhole -- замочная скважина
kick -- пинать, пнуть
kid -- ребенок (разг.), обманывать (сленг.)
kidding -- шутящий, высмеивающий (от kid)
kidnap -- похищать (человека)
kidney -- почка (анатом.)
kids -- дети (от kid)
kill -- убивать
killed -- убил (от kill)
killing -- убийственный (-ing)
kind -- добрый, вид, род
kindly -- добрый, добродушный, ласково, любезно
kindness -- доброта, любезность (k-)
king -- король
kingdom -- королевство
kings -- Короли (TR!)
kiss -- целовать
kit -- ранец, багаж
kitchen -- кухня
kitten -- котенок
kitty -- цель (в игре в кегли)
knee -- колено
knees -- колени !NEW!
knelt -- стоял на коленях !NEW!
knew -- знал (от know)
knife -- нож
knight -- рыцарь
knights -- Рыцари (TR!)
knit -- вязать, связывать
knitted -- вязанный, трикотажный
knob -- knob -- НЕВЫУЧЕННОЕ СЛОВО (TR!)
knock -- стучать, стук
knocked -- стучать (2 форма) *n- !NEW!
knot -- узел, завязывать узел (не kink)
know -- знать
knowing -- знание, знающий
knowledge -- знание
konrad -- Конрад (TR!)
la -- Ла (TR!)
label -- этикетка, приклеивать ярлык
labor -- Рабочая сила (TR!)
laboratory -- лаборатория
labour -- труд, трудиться
labourer -- рабочий
lace -- кружево, шнурок
lack -- недостаток
lad -- мальчик, юноша, парень (не guy)
ladder -- лестница (не stairs)
laden -- Груженый, нагруженный, обремененный (TR!)
ladies -- дамы (от lady)
lads -- парни (не guys) !NEW!
lady -- дама, госпожа
laid -- происходил, совершался (от lay)
lake -- озеро
lamb -- ягненок, баранина
lame -- хромой
lament -- сетование, жалоба (l-)
lamp -- лампа
land -- земля, суша, приземляться, высаживаться на берег
landed -- земельный
landing -- высадка на берег -ing
landlady -- хозяйка (дома, гостиницы) (не mistress)
landlord -- домовладелец
landscape -- ландшафт, пейзаж
landslide -- оползень, обвал (не avalanche)
lane -- дорожка (не road)
language -- язык
lantern -- фонарь
lap -- подол
lapse -- описка
lard -- топленое свиное сало
large -- большой
largely -- обильно *a-
larger -- Больший (TR!)
largest -- Самый большой (TR!)
lark -- жаворонок
larva -- личинка, головастик
lash -- хлестать, ударять; плеть
last -- прошлый, последний, продолжаться, длиться
lastly -- Наконец (TR!)
latch -- запирать(ся)
late -- поздно
lately -- за последнее время
later -- позже
lateral -- Боковой *a- (TR!)
latest -- последний (не latter)
latter -- последний
laugh -- смех, смеяться
laughed -- смеялся, хохотал (от laugh)
laughing -- смех, смеющийся
laughter -- смех, хохот
launch -- начинать
launching -- спуск (на воду), начало -ing
laundry -- прачечная, стирка
laurie -- Лаури (TR!)
lavish -- щедрый, обильный
law -- закон, право
lawn -- лужайка
laws -- Законы (TR!)
lawyer -- адвокат, юрист
lay -- класть, положить
laying -- Наложение -ing (TR!)
laziness -- лень
lazy -- ленивый
lead -- вести, руководить
leader -- глава, лидер
leadership -- руководство
leading -- лидирование, руководящий
leads -- Лидерство (TR!)
leaf -- лист
leaflet -- Рекламный листок (TR!)
leaflets -- Рекламные листки (TR!)
league -- союз, лига
leak -- просачиваться
lean -- прислоняться, наклоняться, наклон
leap -- високосный, прыжок, прыгать
leaped -- Прыгал (не sprang, jumped, hopped) (TR!)
leapt -- прыгал !NEW!
learn -- узнать, учиться
learned -- ученый
learning -- учение
learnt -- узнал, выученный (от learn)
lease -- аренда, сдавать в аренду
leash -- поводок, цепь (не strap)
least -- наименьший, менее всего
leather -- кожа, кожаный
leave -- оставлять, покидать, уезжать
leaving -- уезжающий (от leave)
lecture -- лекция
ledge -- выступ, край l-
lee -- Защита (TR!)
left -- покинутый, оставленный (от leave)
leg -- нога
legacy -- наследство
legal -- законный
legally -- законно
legend -- легенда
legitimate -- обоснованный
leisure -- досуг
leisurely -- не спеша
lemon -- лимон
lemonade -- лимонад
lend -- дать в долг
length -- длина
lens -- линза
lent -- одолжил, дал в долг (от lend)
less -- менее, в меньшей степени (от little)
lessen -- уменьшать l-
lesson -- урок
let -- позволять, давать, разрешать
letter -- письмо
letters -- письма (от letter)
letting -- Разрешение -ing (TR!)
lettuce -- салат
level -- уровень
lever -- рычаг
liable -- подлежащий, обязанный, ответственный
liar -- лгун
liberal -- либеральный, щедрый; либерал
liberty -- свобода
librarian -- библиотекарь
libraries -- Библиотеки (TR!)
library -- библиотека
licence -- лицензия, разрешение (*****c*)
license -- давать разрешение
lick -- лизать
lid -- крышка
lie -- ложь, лгать, лежать
life -- жизнь
lifeboat -- спасательная лодка
lift -- поднимать, подъемник, лифт
light -- свет, освещение, фара, освещать, зажигать
lighter -- зажигалка
lighthouse -- маяк
lighting -- освещение
lightly -- слегка !NEW!
lightning -- молния
lights -- фары (от light)
like -- любить, нравиться, похожий, подобный
liked -- нравился, любил (от like)
likelihood -- вероятность
likely -- вероятно
likeness -- сходство l-
likewise -- так же !NEW!
lilac -- сирень, сиреневый
lily -- лилия
limb -- конечность (анат.)
limbs -- конечности !NEW!
lime -- известь
limit -- предел, граница
limitation -- ограничение
limited -- ограниченный
limits -- Пределы (TR!)
limp -- хромота, прихрамывать
line -- линия, специальность
lined -- Выровненный (TR!)
linen -- белье
linger -- медлить, задерживаться
lining -- подкладка
link -- соединять, соединить (link)
lion -- лев
lip -- губа
liquid -- жидкость
liquor -- крепкий спиртной напиток
list -- список
listen -- слушать
listened -- слушал (от listen)
listener -- слушатель
lit -- освещённый !NEW!
literal -- буквальный
literary -- литературный
literature -- литература
litter -- мусор, сорить
little -- мало, маленький
live -- жить
lived -- жил, живший (от live)
lively -- живой, оживленный
liver -- печень
living -- средства к существованию, жизнь
lizard -- ящерица
lizzie -- Автомобильчик (TR!)
load -- нагрузка, нагружать
loaded -- загруженный
loaf -- безделье
loan -- заём, ссуда
lobby -- вестибюль
lobes -- Лепестки (TR!)
lobster -- омар
local -- местный
locate -- определять местоположение !NEW!
located -- Расположенный (TR!)
location -- местоположение
locations -- Местоположения (TR!)
lock -- замок, запирать на замок
locked -- запертый l-
locking -- Захват -ing (TR!)
locks -- Замки (TR!)
locksmith -- слесарь
lodge -- разместить
lodging -- квартира, жилье
loft -- сеновал, чердак
lofty -- высокий, возвышенный
log -- бревно
logic -- логика
login -- Логин (TR!)
logs -- Бревна (TR!)
loneliness -- одиночество !NEW!
lonely -- одинокий
long -- длинный, долгий, долго
longer -- длиннее (от long)
look -- смотреть, выглядеть, взгляд, внешность
looking -- смотрящий (от look) -ing
looks -- выглядит (от like)
loom -- принимать размеры
loop -- петля
loose -- свободный
loosen -- развязывать, распускать, ослаблять
loot -- ограбление
lord -- лорд
lorry -- грузовик (не truck)
los -- Лос (TR!)
lose -- терять, проигрывать
losing -- проигрыш, проигранный
loss -- потеря, утрата
lost -- потерял, проиграл, потерянный, проигранный (от lose)
lot -- много
lots -- уйма, куча, множество (не pile) !NEW!
loud -- громкий
louder -- громче
loudly -- громко
louisa -- Луиза (TR!)
louise -- Луиза (TR!)
love -- любовь, любить
loved -- любил (от love)
lovely -- прекрасный, восхитительный l-
lover -- любитель, возлюбленный
lovers -- Любители(возлюбленные) (TR!)
loving -- любящий
low -- низкий
lower -- нижний, снижать, опускать
lowered -- Пониженный (TR!)
loyal -- верный, лояльный
loyalty -- верность
lucidly -- понятно, ясно *u-
lucius -- Лусиус (TR!)
luck -- удача, везение
luckily -- к счастью
lucky -- счастливый, удачный
lucy -- Люси (TR!)
luggage -- багаж
luke -- Лук (TR!)
lumber -- лесоматериалы *u-
lump -- глыба, ком
lunch -- второй завтрак, обед
luncheon -- обед, лёгкая закуска
lustre -- блеск, лоск, глянец, люстра
luxurious -- роскошный
luxury -- роскошь
lydia -- Лидия (TR!)
machine -- машина
machinery -- машины, механизмы
mad -- обезумевший
madam -- госпожа
madame -- Мадам (TR!)
made -- делал, сделанный (от make)
madeira -- Мадейра (TR!)
madly -- безумно !NEW!
magazine -- журнал
magazines -- журналы (от magazine)
magic -- волшебный m-
magician -- волшебник
magnificent -- великолепный m-
maid -- горничная
mail -- почта, отправлять (по почте)
main -- главный
mainland -- материк
mainly -- главным образом
maintain -- поддерживать
maintained -- Обслуженный(поддержанный) (TR!)
maintenance -- поддержание
majesty -- величественность, величество (титул)
major -- специализироваться, главный m-
majority -- большинство
make -- делать, производить
maker -- производитель (m-)
makes -- делает (от make)
making -- создание, становление (процесс) !NEW!
male -- мужчина, самец
malice -- злоба
malicious -- злобный
malignant -- злобный, злостный, злокачественный (****g)
mallet -- деревянный молоток
mallow -- Просвирник (TR!)
mama -- Мама (TR!)
mamma -- Мама (TR!)
man -- мужчина, человек
manage -- справляться, ухитряться, управлять
management -- управление
manager -- управляющий
manages -- ухитряется (от manage)
mane -- грива
mania -- мания
manifest -- явный, проявлять(ся) m-
manipulate -- манипулировать
manipulation -- Манипуляция (TR!)
mankind -- человечество
manner -- способ, образ действия, манера
manners -- способы (не methods) !NEW!
manoeuvre -- маневр, маневрировать
mansfield -- Мансфилд (TR!)
mansion -- дворец
mantle -- покрывать, окутывать
manual -- ручной
manufacture -- производство, производить m-
manure -- удобрение
manuscript -- рукопись
many -- много (с исчисляемыми существительными)
map -- карта
marble -- мрамор
march -- маршировать
marched -- Прошел (TR!)
marco -- Марко (TR!)
margaret -- Маргарет (TR!)
margarita -- Маргарита (TR!)
margin -- минимум, нижняя грань, предел
maria -- Мария (TR!)
marianne -- Мэрианн (TR!)
marine -- морской флот, морской
mariner -- моряк
mark -- норма, состояние, оценка, отметка
market -- рынок
marks -- оценки (от mark)
marmot -- сурок
marquis -- Маркиз (TR!)
marriage -- свадьба
married -- женатый, замужняя
marry -- жениться, выходить замуж
marrying -- Бракосочетание -ing (TR!)
marsh -- болото m-
martial -- военный
marvel -- удивляться, поражаться m-
marvellous -- удивительный, замечательный m-
mask -- маска
mason -- каменщик
masquerade -- маскарад, маскироваться
mass -- масса, множество
masses -- Массы (TR!)
massive -- массивный
mast -- мачта
master -- хозяин (не hoster)
masterpiece -- шедевр
mat -- коврик (не rug)
match -- спичка, матч
matches -- Сделки, спички (TR!)
mate -- товарищ
material -- материал
materials -- Материалы (TR!)
mathematical -- математический
maths -- математика
matter -- дело, сущность, материал
matters -- дела, материалы (от matter)
mattress -- матрац
mature -- зрелый, созреть
maturity -- зрелость
maud -- Дорожный плед (TR!)
maxim -- принцип
maximum -- Максимум (TR!)
May -- май
maybe -- мoжет быть
mayor -- мэр
me -- мне, меня
meadow -- луг
meal -- еда, есть, принимать пищу (не food)
meals -- еда (от meal)
mean -- означать
meaning -- значение
meaningless -- бессмысленный
means -- средство, способ
meant -- означаемый, подразумеваемый !NEW!
meantime -- между тем
meanwhile -- тем временем, между тем
measles -- корь
measure -- мера
measured -- Измеренный (TR!)
measures -- Меры (TR!)
measuring -- измерения (от measure)
meat -- мясо, мясной
mechanic -- механик
mechanical -- механический
mechanics -- механика
mechanism -- устройство
medal -- медаль
meddle -- вмешиваться
medical -- медицинский
medicine -- медицина, лекарство
medieval -- средневековый
meditate -- размышлять, обдумывать
medium -- средство, середина
meek -- кроткий
meet -- встречать(ся), знакомиться
meeting -- встреча
meg -- Мэг (TR!)
melancholy -- Меланхолия (TR!)
melon -- дыня
melt -- таять
member -- член
members -- члены (от member)
memorable -- памятный
memorandum -- памятная записка
memory -- память
men -- мужчины (от man)
menace -- опасность (не danger)
mend -- чинить, ремонтировать
mended -- починил, починенный (от mend)
mental -- умственный
mentally -- умственно
mention -- благодарность, упоминать
mentioned -- упомянул (от mention)
menu -- меню
merchandise -- торговля
merchant -- торговец (не salesman)
merciful -- милосердный (не gracious)
mercury -- ртуть
mercy -- милость
mere -- простой
merely -- единственно
merge -- Слиться (TR!)
merit -- достоинство
merry -- веселый, радостный m-
mess -- беспорядок, путаница
message -- сообщение, поручение
messenger -- посыльный, курьер
met -- встречались, встреченный (от meet)
metal -- металл, металлический
meter -- счетчик
method -- метод
metropolitan -- столичный
mexican -- Мексиканец (TR!)
mice -- мыши
microphone -- микрофон
microscope -- микроскоп
mid -- средний
midday -- полдень
middle -- средний
midnight -- полночь
midst -- середина
might -- можно, возможно (от may)
mighty -- могущественный
mild -- мягкий (не soft)
mildred -- Милдред (TR!)
mile -- миля
miles -- мили (от mile)
military -- военный
milk -- молоко
mill -- фабрика, завод, мельница
millet -- просо, пшено
million -- миллион
millions -- Миллионы (TR!)
mind -- память, мнение, помнить, возражать
minded -- Склонный (TR!)
minds -- ум !NEW!
mine -- мой (употребляется без последующего существительного)
mineral -- минeральный
mingled -- Смешанный (TR!)
miniaturization -- Миниатюризация (TR!)
minims -- Мельчайшая частица, очень маленькая доля, капля (TR!)
minimum -- минимум
mining -- горный -ing
minister -- министр
ministry -- министерство
minor -- младший, незначительный, второстепенный
minority -- меньшинство
mint -- мята
minus -- минус
minute -- минута
minutes -- минуты (от minute)
miracle -- чудо
mirror -- зеркало
mirth -- веселье, радость
miscellaneous -- смешанный, разнообразный m-
mischief -- зло, беда
mischievous -- злонамеренный, злобный, шаловливый, озорной
miserable -- несчастный
misery -- страдания, нищета
misfortune -- несчастье (m-)
mishap -- неудача (не unluck)
mislead -- вводить в заблуждение
miss -- промах, промахнуться, пропустить, скучать
missing -- недостающий, отсутствующий, пропавший (без вести)
mission -- миссия
missionary -- миссионер
mist -- дымка
mistake -- ошибка
mistaken -- ошибочный (от mistake)
mistress -- хозяйка, госпожа
misty -- туманный mi-
mix -- смешивать, мешать
mixture -- микстура
mm -- Мм (TR!)
moan -- оплакивать, стонать
moaning -- Стенание -ing (TR!)
mob -- толпа, сборище
mobile -- подвижный
mock -- насмехаться (не jeer)
mockery -- издевательство
mode -- способ
model -- модель
moderate -- умеренный
moderately -- Умеренно (TR!)
modern -- современный
modest -- скромный m-
modification -- Модификация (TR!)
modified -- видоизменённый !NEW!
modify -- модифицировать
module -- Модуль (TR!)
moist -- сырой, влажный m-
moisture -- влажность (не humidity)
mole -- крот
molly -- Молли (TR!)
moment -- момент, миг
momentary -- Мгновенный (TR!)
momentum -- импульс
monarch -- монарх
Monday -- понедельник
money -- деньги
monkey -- обезьяна
monks -- Монахи (TR!)
monotonous -- однообразный, монотонный
monsieur -- Господин (TR!)
monster -- чудовище
monsters -- Монстры (TR!)
monstrous -- чудовищный
month -- месяц
monthly -- (еже)месячный, ежемесячно
months -- месяцы (от month)
monument -- памятник (не memorial)
monuments -- памятники (от monument)
mood -- настроение
moon -- луна
moonlight -- лунный свет !NEW!
mop -- швабра, подтирать
moral -- нравственный
more -- еще, больше
moreover -- кроме того
morning -- утро
morrow -- завтра, завтрашний день; следующий день !NEW!
morsel -- кусочек -l
mortal -- смертный, смертельный (не lethal)
mortgage -- заклад, залог
mortimer -- Мортимер (TR!)
morton -- Мортон (TR!)
Moscow -- Москва
mosquito -- комар
moss -- мох
mossy -- мшистый
most -- самый, весьма
mostly -- главным образом (не mainly)
motel -- мотель, гостиница
moth -- моль, мотылек
mother -- мама
motion -- движение
motionless -- неподвижный
motive -- повод, мотив
motives -- Поводы (TR!)
motley -- разноцветный, пестрый
motor -- мотор
mould -- плесень; плесенный грибок
mound -- насыпь, холмик
mount -- взбираться m-
mountain -- гора
mourn -- сетовать
mournful -- грустный
mourning -- траур
mouse -- мышь
moustache -- усы
mouth -- рот
move -- двигать(ся), переезжать
movement -- движение
movements -- Движения (TR!)
movie -- кино, фильм
movies -- кино, фильмы (от movie)
moving -- трогательный
mow -- косить
ms -- Госпожа (TR!)
much -- много (с неисчисляемыми существительными)
mud -- грязь
muddy -- грязный, мутный
muffled -- закутанный, укутанный, завёрнутый (не wrapped) !NEW!
muffler -- шарф
mug -- кружка
muggy -- теплый, влажный, удушливый
mulberry -- Тутовое дерево (TR!)
mule -- мул, тупица, гибрид, туфля без задников
multi -- Много (TR!)
multiple -- многократный -e
multitude -- множество
mumble -- бормотание m-
mummy -- Мумия (TR!)
munch -- чавкать
mural -- стенная живопись, фреска
murder -- убийство
murderer -- убийца
murmur -- шорох, шепот m-
muscle -- мышца
muscles -- Мускулы (TR!)
muscular -- мускулистый
museum -- музей
music -- музыка
musical -- музыкальный, мюзикл
musician -- музыкант
must -- должен, надо
mute -- немой (не dumb)
mutiny -- мятеж, поднять мятеж
mutter -- бормотать
muttered -- Бормотал (TR!)
muttering -- Бормотание -ing (TR!)
mutton -- баранина
mutual -- взаимный, общий (не common)
muzzle -- морда, намордник, дуло
my -- мой, моя, мое, мои
myrtle -- Мирт (TR!)
myself -- себя, меня самого, себе, сам
mysterious -- таинственный
mystery -- тайна
myth -- миф
nab -- курок
nail -- ноготь, гвоздь
nails -- ногти (от nail)
naive -- наивный
naked -- обнаженный, голый
name -- имя, фамилия, называть
namely -- а именно
nan -- Нэн (TR!)
nancy -- Нэнси (TR!)
napkin -- салфетка, пеленка
napoleon -- Наполеон (TR!)
narrative -- повествование, рассказ
narrow -- узкий
nasty -- скверный, плохой
nat -- Нат (TR!)
nation -- нация, народ
national -- национальный
nations -- Нации (TR!)
native -- родной
natives -- Аборигены (TR!)
natural -- естественный
naturalist -- Натуралист (TR!)
naturalists -- Натуралисты (TR!)
naturally -- естественно
nature -- природа
naughty -- непослушный
navigation -- судоходство, плавание, навигация
navy -- военный флот
nay -- более того, даже; отрицательный ответ; отказ;
near -- близко от, около
nearby -- поблизости (nearby)
nearest -- ближайший (от near)
nearly -- почти, приблизительно (не almost)
neat -- чистый, опрятный n-
neatly -- аккуратно !NEW!
necessarily -- обязательно
necessary -- нужный, необходимый
necessity -- необходимость
neck -- шея
necklace -- ожерелье
ned -- Нед (TR!)
need -- нуждаться в, надо, нужда, потребность
needle -- игла
needlework -- шитье
negative -- отрицательный, отрицание, негатив
neglect -- пренебрегать
neglected -- Пренебрег (TR!)
negligence -- небрежность
negotiate -- договариваться
neighbour -- сосед
neighbourhood -- соседство
neighbouring -- соседний
neither -- также не
nell -- Нелл (TR!)
nephew -- племянник
nerve -- нерв
nerves -- нервы (от nerve)
nervous -- нервный
nest -- гнездо
net -- сеть
network -- сеть
neutral -- нейтральный
never -- никогда
nevertheless -- тем не менее
neville -- Невилл (TR!)
new -- новый
newcomer -- новичок (не beginner)
newly -- вновь (не again)
news -- новости, известия
newsletter -- новости
newspaper -- газета
newspapers -- газеты (от newspaper)
next -- следующий, соседний, затем, потом
nice -- хороший, чудесный, приятный
nicely -- хорошо
nicer -- лучше (от nice)
nicest -- самый вкусный (от nice)
niche -- ниша
nicholas -- Николас (TR!)
nick -- Зарубка (TR!)
nickel -- никл (монета в 5 центов)
nickname -- прозвище
niece -- племянница
nieces -- Племянницы (TR!)
night -- ночь
nightingale -- соловей
nightmare -- кошмар
nights -- ночи (от night)
nine -- девять
nineteen -- девятнадцать
nineteenth -- девятнадцатый
ninety -- девяносто
ninth -- девятый
nip -- укус, щипать, пересечь
no -- нет, никакой
noble -- благородный, знатный
nobleman -- дворянин
nobles -- Знать (знатные люди) (TR!)
nobody -- никто
nod -- кивать головой, кивок
nodding -- Кивающий (TR!)
node -- Узел (не knot) (TR!)
noise -- шум
noiseless -- бесшумный
noises -- Шумы (TR!)
noisy -- шумный
non -- не
none -- нисколько, совсем не, вовсе не
nonsense -- чепуха, ерунда
noon -- полдень
nor -- и не, также не
normal -- нормальный
normally -- обычно n-
normandy -- Нормандия (TR!)
norris -- Норрис (TR!)
North -- север
northern -- северный
nose -- нос
nostril -- ноздря
nostrils -- Ноздри (TR!)
not -- не
notable -- заметный
notably -- исключительно
note -- запись, записка, банкнота, записывать
notebook -- тетрадь (n-)
nothing -- ничто, ничего
notice -- извещение, сообщение, замечать, обращать внимание
notify -- извещать, уведомлять (не inform)
notion -- понятие
notions -- Понятия (TR!)
notorious -- известный, отъявленный
notwithstanding -- несмотря на, тем не менее, однако
nourishing -- питательный (-ing)
nourishment -- питание, пища
novel -- роман
novelty -- новизна, новинка
November -- ноябрь
now -- сейчас
nowadays -- в наше время
nowhere -- нигде, никуда
nuisance -- досада
null -- Пустой указатель (TR!)
nulls -- Пустые указатели (TR!)
numb -- онемелый, оцепенелый (не dumb, )
number -- номер
numbers -- Номера(числа) (TR!)
numerals -- числительные (от numeral)
numeric -- Числовой (TR!)
numerous -- многочисленный
nurse -- няня (не nanny)
nursery -- детский, ясли
nut -- орех
nuts -- орехи (от nut)
nylon -- нейлон, нейлоновый
oak -- дуб
oar -- весло
oars -- вёсла !NEW!
oath -- клятва, присяга
obedience -- послушание
obedient -- послушный
obey -- подчиняться, слушаться
object -- возражать, предмет
objected -- Возразил (не retorted) (TR!)
objection -- возражение, протест
objections -- возражения (от objection)
objective -- цель, стремление (-ve)
objects -- Объекты(цели) (TR!)
obligation -- обязательство
oblige -- обязывать
obliged -- обязан, признателен (от oblige)
obscure -- затемнять, затруднять понимание
observation -- наблюдение, замечание
observe -- наблюдать, замечать (не outlook)
observed -- наблюдаемый !NEW!
observer -- наблюдатель
obstacle -- препятствие
obtain -- добиваться
obtained -- Полученный *b- (TR!)
obvious -- очевидный o-
obviously -- очевидно o-
occasion -- случай, обстоятельство
occasional -- случайный
occasionally -- изредка
occasioned -- Причиняемый (TR!)
occupation -- занятие
occupied -- занятый !NEW!
occupy -- занимать, завоёвывать
occur -- случаться
occurrence -- Возникновение (TR!)
occurs -- Происходит (TR!)
ocean -- океан
octavian -- Октавиан (TR!)
October -- октябрь
odd -- странный
odds -- разница, неравенство
odour -- запах, аромат o-
of -- предлог родительного падежа (кого?, чего?)
off -- прочь, от
offence -- обида
offend -- обижать, обидеть (o-)
offended -- обиженный !NEW!
offensive -- наступление
offer -- предлагать
offering -- предложение
office -- офис, контора
officer -- служащий, офицер
official -- официальный, чиновник
officially -- официально
offset -- смещенный
offspring -- Потомство (TR!)
often -- часто
oh -- O!
oil -- масло
OK -- все в порядке
old -- старый
oldest -- старший, самый старый
olive -- олива, маслина; оливкового цвета
omelette -- омлет
ominous -- зловещий
omit -- опускать, пропускать, упускать
on -- на, вперед, дальше
once -- один раз, однажды
oneself -- (самого) себя o-
onion -- лук
only -- только, единственный
onto -- на (не upon)
onward -- вперед, далее, продвигающийся вперед
open -- открывать
opened -- открыл, открытый (от open)
opening -- начало, открытие
openly -- открыто
opera -- опера
operate -- действовать
operating -- управляющий -ing
operation -- действие, операция
operative -- действующий o-ve
operator -- оператор
opinion -- мнение
opponent -- соперник
opportunity -- возможность
opposed -- Противопоставленный (TR!)
opposite -- противоположный
opposition -- противодействие
oppressive -- гнетущий, деспотический
opt -- выбирать
option -- выбор (o-)
optional -- Дополнительный (TR!)
options -- Выбора (TR!)
or -- или
orange -- апельсин, оранжевый
oranges -- апельсины (от orange)
orchard -- фруктовый сад
orchestra -- партер, оркестр
order -- порядок, приказ, заказ, заказывать, приказывать
ordered -- приказал (от order)
orderly -- аккуратный
ordinal -- порядковый
ordinarily -- обыкновенным, обычным путем; обычно; нормально; в обычной степени
ordinary -- обычный, простой
organ -- орган
organic -- органический
organization -- организация
organize -- организовывать
organized -- организовывал (от organize)
organizer -- организатор
organs -- Органы (TR!)
oriental -- восточный
origin -- происхождение
original -- оригинал, первоначальный
originally -- первоначально
originate -- возникать, происходить, давать начало, порождать; создавать
ornament -- украшение, орнамент; украшать
orphan -- сирота, сиротский
ostrich -- страус
other -- другой
otherwise -- иначе
ought -- долженствование
our -- наш
ours -- наш
ourselves -- себя, себе, сами
out -- вне, вон, из, снаружи, наружный
outbreak -- взрыв, вспышка, начало (войны и т.п.)
outcome -- результат
outcry -- крик, протест
outdoor -- на открытом воздухе
outer -- внешний
outfit -- снаряжение, обмундирование, оборудование
outlaw -- человек вне закона, изгнанник
outlet -- выход, выходное отверстие
outline -- контур, конспект, план, схема; краткое содержание
output -- выпуск, продукция
outrage -- нарушение закона, насилие, оскорблять
outright -- открыто, прямо; без утайки (не straight, directly)
outside -- снаружи, наружный
outskirts -- окраина (города), опушка (леса)
outstanding -- выдающийся *u-
outward -- внешний, наружный (не outside)
outwit -- перехитрить
oven -- печь
over -- через, над, сверх
overall -- всеобщий o-
overcoat -- пальто
overcome -- преодолеть
overflow -- переливаться через край, заливать, переполнять
overhead -- наверху, над головой, верхний
overhear -- подслушивать
overjoyed -- вне себя от радости, очень довольный
overload -- перегружать
overlook -- надзирать
override -- наехать, переехать; задавить Отвергнуть (TR!)
overthrow -- свергать
overtime -- сверхурочные
overturn -- опрокидывать(ся), ниспровергать
overwhelm -- засыпать, забрасывать (вопросами), сокрушать
overwhelming -- несметный
owe -- быть должным
owen -- Оуэн (TR!)
owing -- должный
owl -- сова
own -- иметь, владеть, свой, собственный
owner -- владелец
owners -- Владельцы (TR!)
ownership -- собственность
ox -- бык
oxbow -- ярмо
oxygen -- кислород
oyster -- устрица
oysters -- устрицы (от oyster)
oz -- Унция (TR!)
pace -- шагать
pacific -- мирный
pack -- упаковывать, упаковать
package -- пакет
packet -- пакет (не bundle)
pad -- мягкая прокладка, подушка; подбивать (ватой и т.п.)
paddle -- короткое весло, грести одним веслом; шлепать по воде
padlock -- висячий замок
page -- страница
paid -- платил, оплаченный (от pay)
pail -- ведро
pain -- боль, страдание
painful -- причиняющий боль, мучительный
pains -- боли, страдания (от pain)
paint -- красить, краска
painter -- художник
painting -- живопись
pair -- пара
pairs -- Пары (TR!)
pal -- приятель, товарищ, дружок
palace -- дворец
pale -- бледный
palm -- ладонь
pamphlet -- брошюра, памфлет
pan -- сковорода
pane -- оконное стекло
panel -- комиссия
pang -- острая боль
panic -- паника
pant -- задыхаться (не gasp)
pantomime -- Пантомима (TR!)
pantry -- кладовая, чулан (не closet)
paper -- бумага, газета
parade -- парад
paragraph -- параграф
parallel -- параллельный
parameter -- Параметр (TR!)
parameters -- Параметры (TR!)
parcel -- пакет *a-
parchment -- Пергамент (TR!)
pardon -- извинение
parent -- родитель, родственник
parents -- родители (от parent)
park -- парк, (при)парковать(ся)
parked -- Припаркованный (TR!)
parking -- стоянка
parliament -- парламент
parlor -- Комната (TR!)
parlour -- кабинет p-
parrot -- попугай
parrots -- Попугаи (TR!)
parsley -- петрушка (бот.)
part -- часть, доля, роль, делить, расставаться, расходиться
parted -- Разделенный (TR!)
partial -- частичный
partially -- Частично (TR!)
participate -- участвовать
particles -- Частицы (TR!)
particular -- особый
particularly -- особенно, в особенности
parties -- вечеринки (от party)
parting -- прощание
partition -- разделение
partly -- частично
partner -- участник
parts -- части (от part)
party -- вечеринка, группа
pass -- передавать, проходить, пропуск, перевал
passage -- проход
passages -- проходы !NEW!
passed -- прошел (от pass)
passenger -- пассажир
passengers -- Пассажиры (TR!)
passing -- прохождение
passion -- страсть
passionate -- страстный
password -- Пароль (TR!)
passwords -- Пароли (TR!)
past -- после, за
paste -- тесто, клейстер, паста; клеить, склеивать
pasture -- пастбище
pat -- хлопок
patch -- заплатка
path -- тропинка, беговая дорожка
pathetic -- трогательный
paths -- Дорожки (не roads, lanes) (TR!)
patience -- терпение
patient -- пациент, терпеливый
patiently -- Терпеливо (TR!)
patrol -- патруль
patsy -- Паци (TR!)
patted -- Ласкал (TR!)
pattern -- модель
paul -- пол !NEW!
pause -- пауза
pausing -- Приостановка -ing (TR!)
pavement -- тротуар (не sidewalk)
paw -- лапа
paws -- Лапы (TR!)
pay -- платить, зарплата
paying -- платеж
payment -- плата
pea -- горох
peace -- мир
peaceable -- миролюбивый, мирный
peaceful -- мирный, спокойный
peacefully -- мирно
peach -- персик
peaches -- персики (от peach)
peacock -- павлин
peak -- вершина
peal -- трезвон, раскат грома
peanut -- земляной орех
pear -- груша
pearl -- жемчуг, жемчужный
pearls -- Жемчуг (TR!)
pears -- груши (от pear)
peas -- горошек, горох
pebble -- галька, горный хрусталь
peck -- клевать
peculiar -- особенный p-
peculiarities -- Особенности (TR!)
pedal -- педаль
pedestrian -- пешеход
peeks -- (он) Посмотрит -s (TR!)
peel -- чистить, почистить
peep -- проблеск, выглядывать
peer -- вглядываться, всматриваться p-
peered -- Глядел (*e-) (TR!)
peering -- Глядя -ing (TR!)
peeves -- Обиды (TR!)
peg -- целиться
pen -- ручка
pencil -- карандаш
pending -- во время, в течение
penetrate -- проникать внутрь
penholder -- ручка (для пера)
penknife -- перочинный нож
penny -- пенни
pensioner -- пенсионер
people -- люди
pepper -- перец
per -- в
perceive -- воспринимать, ощущать
perceived -- Воспринятый (TR!)
percent -- процент
percy -- Перси (TR!)
perfect -- совершенный
perfection -- совершенство
perfectly -- совершенно, вполне
perform -- делать, выполнять
performance -- спектакль
performed -- Выполненный (не от слова fulfil) (TR!)
perfume -- духи
perhaps -- возможно, может быть
peril -- опасность
perilous -- опасный, рискованный
period -- период
periodic -- периодический
periods -- Периоды (TR!)
permanent -- постоянный
permanently -- постоянно
permissible -- допустимый
permission -- разрешение
permit -- разрешать
permitted -- Разрешенный (TR!)
perpendicular -- перпендикулярный
perpetual -- вечный, постоянный p-
perry -- Перри (TR!)
persecution -- преследование
perseverance -- настойчивость, упорство
persian -- Персидский (TR!)
persistent -- настойчивый
person -- человек, особа, лицо, личность
personal -- личный
personally -- лично
persons -- Люди (TR!)
perspective -- перспектива, перспективный
persuade -- убеждать
persuaded -- Убежденный (не convinced) (TR!)
perverse -- извращенный, испорченный, превратный
pest -- паразит, вредитель, бич
pet -- любимое домашнее животное, любимец
peter -- Питер (TR!)
petition -- петиция, прошение, подавать петицию
petrol -- бензин
pets -- домашние животные (от pet)
phantom -- Фантом (TR!)
phase -- фаза, фазировать
philadelphia -- Филадельфия (TR!)
philip -- Филип (TR!)
philosophical -- философский
philosophy -- философия
phone -- телефон
phosphate -- Фосфат (TR!)
photo -- фотография
photograph -- фотография, фотографировать
photographer -- фотограф
photographic -- фотографический
photographing -- фотографирование
photography -- фотография
phrase -- фраза
physical -- физический
physically -- физически
physician -- врач
piano -- пианино
pick -- собирать, подбирать, выбирать
picked -- собранный, выбранный !NEW!
pickles -- маринованные огурцы
picnic -- пикник
picture -- картина, изображение, рисовать, описывать
pictures -- картины (от picture)
picturesque -- живописный
pie -- пирог
piece -- кусок
pier -- пристань, мол, свая, бык
pierce -- пронзать, протыкать, пронизывать, проникать
pierre -- Пирр (TR!)
pig -- свинья
pigeon -- голубь
pigeons -- Голуби (TR!)
pigs -- Свиньи (TR!)
pike -- щука (не lung)
pile -- куча, груда, кипа, пачка
piled -- Сложенный (TR!)
pillar -- колонна, столб p-
pillow -- подушка
pills -- таблетки (от pill)
pilot -- пилот
pin -- булавка, значок, прикалывать
pincers -- клещи, щипцы
pinch -- щипать, прищемить, щипок
pinching -- Зажимание -ing (TR!)
pine -- сосна
pineapple -- ананас
pink -- розовый
pins -- значки (от pin)
pious -- набожный
pipe -- труба (не tube)
pirate -- пират
pistol -- револьвер, пистолет
pit -- яма, партер (не dig)
pitch -- бросок, уровень, сооружать
pitched -- Переданный (TR!)
pitcher -- подающий
piteous -- жалкий, жалобный
pitiful -- жалкий, ничтожный
pity -- жалость
pizza -- пицца
place -- место
placing -- Размещение -ing (TR!)
plain -- ясный, очевидный, равнина
plainly -- Явно (не clearly, obvious) (TR!)
plains -- Равнины (TR!)
plan -- план, планировать
plane -- самолет
planes -- самолеты (от plane)
planet -- планета
planets -- Планеты (TR!)
plank -- доска (p-)
planned -- плановый
planning -- планирование
plans -- планы (от plan)
plant -- завод, растение, сажать, внедрять, посадить
plantation -- плантация
plants -- Заводы(растения) (TR!)
plaster -- пластырь, штукатурка, штукатурить
plastic -- пластмасса, пластичный
plate -- тарелка
plates -- тарелки (от plate)
platform -- платформа
platforms -- Платформы (TR!)
play -- играть, игра (play)
played -- играл (от play)
player -- плейер, игрок
playing -- играющий (от play)
plays -- играет (от play)
playwright -- драматург
pleaded -- Умолял (TR!)
pleasant -- приятный
pleasantly -- приятно !NEW!
please -- пожалуйста (только в просьбе)
pleased -- довольный
pleasure -- удовольствие
plenty -- изобилие, избыток, вполне, довольно
plot -- заговор
plough -- пахать
pluck -- ощипывать, выщипывать, рвать (цветы)
plucky -- смелый, отважный (не manful)
plug -- пробка (не cork)
plum -- слива
plumage -- Оперение (TR!)
plume -- перо
plump -- пухлый, полный (не swell)
plums -- сливы (от plum)
plunder -- добыча, грабить
plunge -- нырять p-
plunged -- Погруженный (TR!)
plural -- множественное число (грам.)
plus -- плюс
pocket -- карман
pockets -- карманы !NEW!
pod -- стручок, лущить
poem -- стихотворение, поэма
poems -- стихи (от poem)
poet -- поэт
poetry -- поэзия, стихи
point -- точка, пункт, суть дела, указывать, показывать
pointed -- острый, многозначительный, совершенно очевидный
pointing -- указывающий (-ing) !NEW!
points -- Пункты(точки) (TR!)
poison -- яд, отравлять
poisonous -- ядовитый
poke -- толчок, тыкать
poking -- Тыкание -ing (TR!)
polar -- полярный
pole -- полюс
police -- полиция
policeman -- полицейский
policy -- политика
polish -- лак
polite -- любезный, вежливый
politely -- вежливо !NEW!
politeness -- Вежливость (TR!)
political -- политический
politics -- политика
poll -- подсчет (голосов), голосование; голосовать, подсчитывать голоса
pollen -- Пыльца (TR!)
pompey -- Помпей (TR!)
pond -- пруд (не pool)
pony -- пони
pool -- пруд, бассейн
poor -- бедный
poorly -- плохо, неважно
pop -- поп, популярный
popped -- Совавший (TR!)
popular -- популярный
population -- население, жители
porcelain -- фарфор
porch -- крыльцо, (амер.) веранда, терраса
pore -- пора
pork -- свинина
porridge -- каша
port -- порт
portable -- переносной
ported -- Перенесенный, транспортированный (TR!)
porter -- носильщик
portion -- часть, доля (не section, segment)
portions -- Части *o- (TR!)
portrait -- портрет
ports -- порты (от port)
pose -- поза, ставить (вопрос, задачу)
position -- положение
positive -- положительный
positively -- Положительно (TR!)
possess -- обладать
possessed -- хладнокровный, владеющий собой, одержимый !NEW!
possession -- владение
possibility -- возможность p-
possible -- возможный
possibly -- возможно
post -- почта, после
postage -- почтовые расходы
postal -- почтовый
postcard -- почтовая открытка
poster -- плакат
postman -- почтальон
postpone -- отсрочивать
pot -- котелок
potato -- картофель
potatoes -- картофель (от potato)
potential -- потенциал, потенциальный
potentially -- потенциально
potion -- Микстура (TR!)
potions -- Микстуры (TR!)
pots -- Горшки (TR!)
potter -- Гончар (TR!)
poultry -- домашняя птица
pounce -- налетать
pound -- фунт, фунт стерлингов
pounds -- фунты (от pound)
pour -- лить
poured -- Лил (TR!)
poverty -- бедность
powder -- пудра
power -- держава, энергия, сила, мощность (не force)
powerful -- могущественный, сильный
powerfully -- сильно (p-)
powers -- Полномочия (TR!)
practicable -- осуществимый
practical -- практический
practically -- практический
practice -- практика
practiced -- применял, практиковал (от practice)
practise -- заниматься
praise -- хвалить
praised -- хвалил (от praise)
prank -- проделка, разряжаться
pray -- молить
prayer -- молитва, просьба
prayers -- Просьбы(просители) (TR!)
pre -- Пред (TR!)
preach -- проповедовать
precarious -- ненадежный *r-
precaution -- предосторожность
preceding -- предшествующий -ing
precious -- драгоценный
precise -- точный
precisely -- точно
precision -- точность
predator -- хищник
predicate -- сказуемое (грам.)
prediction -- предсказание
prefer -- предпочитать
preference -- предпочтение
preferred -- предпочитал (от prefer)
prefix -- (грам.) префикс, приставка
pregnant -- беременная, чреватый (последствиями и т. п.)
preliminary -- предварительный (p- не preparatory)
preparation -- приготовление
preparations -- Приготовления (TR!)
prepare -- готовить(ся)
prepared -- готовился, готовый (от prepare)
preparing -- Подготовка (TR!)
preponderant -- преобладающий
prescription -- рецепт
presence -- присутствие
present -- настоящее время, подарок, настоящий, присутствующий
presented -- Представленный (TR!)
presentiment -- предчувствие
presently -- вскоре
presents -- подарки (от present)
preservation -- сохранение, сохранность, консервирование
preserve -- сохранять
preserved -- Сохраненный (TR!)
president -- президент
press -- (по)гладить, сжимать, нажимать, печать, пресса
pressed -- поглаженный, сжатый (от press)
pressing -- срочный, настойчивый
pressure -- давление
presumably -- возможно
presume -- предполагать (не suppose)
pretence -- притворство
pretend -- притворяться, делать вид
pretty -- хороший, значительный
prevail -- торжествовать (не triumph)
prevailed -- Преобладал (TR!)
prevent -- предотвращать, препятствовать
prevented -- Предотвращенный (TR!)
preview -- предварительный просмотр
previous -- предшествующий
previously -- предварительно
prey -- жертва
price -- цена
priceless -- бесценный
prick -- (у)колоть(ся)
prickly -- колючий
pride -- гордость
priest -- священник
primary -- первичный
prime -- главный (не chief, major)
prince -- принц
princess -- Принцесса (TR!)
principal -- главный, основной, важнейший p-
principle -- принцип
principles -- Принципы (TR!)
print -- печатать, напечатать
printing -- печатание
prior -- прежний
priority -- приоритет
prison -- тюрьма
prisoner -- заключенный
prisoners -- Заключенные (TR!)
privacy -- уединенность
private -- частный
privately -- конфиденциально
privilege -- привилегия
privileged -- привилегированный
prize -- приз
probability -- вероятность
probable -- вероятный (-e)
probably -- вероятно (-y)
problem -- проблема
problems -- проблемы (от problem)
procedure -- процедура
procedures -- Процедуры (TR!)
proceed -- продолжать
proceeding -- поступок, мероприятие, протоколы, записки
proceedings -- труды, записки
process -- процесс
processes -- Процессы (TR!)
procession -- процессия
proclamation -- воззвание, прокламация
procurator -- Поверенный (TR!)
procure -- доставать, добывать
procured -- Обеспеченный (не provided, supplied) (TR!)
produce -- производить
produced -- производил (от produce)
producer -- режиссер
produces -- Производит (TR!)
producing -- Создание -ing (TR!)
product -- продукция
production -- производство
productions -- Производство (TR!)
profession -- профессия
professional -- профессиональный
professor -- профессор
profit -- прибыль
profitable -- прибыльный, выгодный, полезный
profound -- глубокий
program -- программа
programme -- программа
programmes -- программы, передачи (от programme)
programming -- программирование
programs -- программы (от program)
progress -- прогресс, успех
prohibited -- запрещенный (от prohibit)
project -- проект
projects -- проекты (от project)
prolong -- продлевать
prominent -- выдающийся
promise -- обещать
promised -- обещал (от promise)
promising -- многообещающий -ing
promotion -- поощрение
prompt -- проворный, быстрый
promptly -- быстро
prone -- склонный
pronounce -- произносить
pronounced -- Явный (TR!)
pronunciation -- произношение
proof -- доказательство
prop -- подпорка, опора, подпирать
proper -- правильный
properly -- правильно, должным образом
property -- собственность, имущество
prophet -- пророк
proportion -- пропорция
proposal -- предложение
propose -- предлагать (не suggest)
proposed -- Предложенный (TR!)
proposition -- предложение
prospect -- перспектива
prospects -- Перспективы (TR!)
prosper -- процветать
prosperity -- процветание, благосостояние
prosperous -- преуспевающий
protect -- защищать, предохранять
protected -- Защищенный (TR!)
protection -- защита
protective -- защитный
protest -- протестовать, протест
protocol -- Протокол (TR!)
proud -- гордый
proudly -- гордо
prove -- доказывать, доказать
proved -- Доказанный (TR!)
provide -- обеспечивать
provided -- при условии
providence -- провидение
provision -- заготовка
provisions -- Условия (не conditions) (TR!)
provocative -- вызывающий, провокационный
provoke -- вызывать, провоцировать
prudent -- осторожный, благоразумный (не careful)
pry -- любопытный человек
psychology -- психология
pub -- трактир, гостиница
public -- общественный (не social)
publication -- публикация
publicity -- гласность
publicly -- публично
publish -- публиковать
published -- публиковал, опубликованный (от publish)
pudding -- пудинг
puddle -- лужица, смущать, барахтаться в воде
puff -- дымок, дуновение (ветра); дымить, попыхивать p-
pug -- мопс, моська, курносый нос
pull -- тянуть, тащить
pullover -- пуловер
pulp -- мякоть, бумажная масса
pulse -- пульс, пульсировать
pump -- насос
pumpkin -- тыква
pun -- каламбур
punch -- пробивать (отверстия), ударять кулаком, удар кулаком, пунш
punctual -- пунктуальный, аккуратный
punish -- наказывать, наказать
punishment -- наказание
pupil -- ученик
purchase -- покупка, покупать
purchaser -- покупатель
pure -- чистый
purge -- чистка (не clean)
purple -- лиловый, малиновый
purpose -- цель
purposes -- Цели (TR!)
purse -- кошелек
pursue -- преследование
pursued -- Преследуемый (TR!)
pursuing -- Преследование -ing (TR!)
pursuit -- преследование, погоня, занятие
push -- толкать
pushed -- вытолкнутый !NEW!
pushing -- Подталкивание(выдвижение) -ing (TR!)
put -- класть, размещать
puzzle -- приводить в затруднение, загадка
puzzled -- озадачен, поставлен в тупик (от puzzle)
pyjamas -- пижама
pyramid -- пирамида
qualify -- квалифицировать
qualities -- Качества (TR!)
quality -- качество
quantity -- количество
quarrel -- ссора, ссориться
quarter -- четверть, квартал
quarx‡ -- d‡z ноломня, карьер
quay -- набережная
Queen -- королева
queer -- странный, эксцентричный
quench -- утолять (жажду)
query -- вопрос, спрашивать
quest -- поиски
question -- вопрос
questionable -- сомнительный
questions -- вопросы (от question)
quick -- быстрый
quicker -- быстрее (от quick)
quickly -- быстро
quiet -- тихий, спокойный
quietly -- тихо, спокойно
quill -- катушка q-
quit -- прекращать
quite -- вполне, совсем
quiver -- дрожать, трепетать; дрожь; трепет
quivering -- дрожащий -ing (не от слов tremble, shiver)
quiz -- опрос, проверять знания
quotation -- цитата
quote -- цитировать
quoted -- Указанный (TR!)
rabbit -- кролик
rabbits -- Кролики (TR!)
race -- раса, гонка
races -- Гонки(расы) (TR!)
racing -- гоночный (-ing)
rack -- полка для багажа над сиденьем
racket -- ракетка
radiant -- лучистый, сияющий, лучезарный
radiator -- радиатор
radio -- радио
radioactive -- радиоактивный
raft -- плот !NEW!
rag -- тряпка, лохмотья
rage -- гнев, ярость (не fury)
ragged -- истрепанный, оборванный, рваный r-
raid -- нападение
rail -- рельс
railing -- ограда, перила -ing
railroad -- железная дорога
railway -- железная дорога
rain -- дождь
rainbow -- радуга
raincoat -- плащ
rainy -- дождливый
raise -- поднимать, возвышать
raised -- рельефный
raising -- воспитание
rake -- грабли, сгребать
ralph -- Ральф (TR!)
ram -- баран
ran -- бежал, убежавший (от run)
ranch -- ранчо
random -- случайный, беспорядочный
rang -- звонил !NEW!
range -- ряд, линия, диапазон
ranger -- скиталец
rank -- ряд, чин, выстраивать
ransom -- выкуп, выкупать
rapid -- быстрый r-
rapidly -- быстро
rapt -- восхищенный, похищенный
rapture -- восторг, восхищение (не delight)
rare -- редкий, недожаренный
rarely -- редко
rash -- стремительный, поспешный, опрометчивый; сыпь
raspberry -- малина
rat -- крыса
rate -- тариф, расценка, степень, оценивать
rates -- стоит (от rate)
rather -- скорее, лучше
rational -- рациональный
rattle -- трещать, греметь, грохотать; треск, грохот, погремушка, трещотка
raw -- сырой
ray -- луч
raymond -- Раймонд (TR!)
razor -- бритва
reach -- достигать
react -- реагировать
reaction -- реакция
read -- читать
reader -- читатель
readily -- охотно r-
readiness -- находчивость
reading -- чтение
ready -- готовый
real -- реальный, настоящий
realistic -- реалистический
reality -- действительность
realize -- представлять себе, реализовать
really -- на самом деле, действительно r-
realm -- Царство (TR!)
rear -- задняя часть
reared -- Воздвигнутый (TR!)
reason -- причина, довод, разум, рассудок
reasonable -- разумный r-
reasonably -- разумно
reasoning -- Рассуждение -ing (TR!)
reassure -- заверять
rebellion -- восстание, бунт
rebellious -- мятежный, бунтарский
rebuff -- неудача, отпор
recall -- припомнить, отозвать
recalled -- Отозванный (TR!)
receipt -- квитанция
receive -- получать
receiver -- приемник
receiving -- Получение -ing (TR!)
recent -- недавний
recently -- недавно
reception -- прием
recipe -- рецепт
recite -- рассказывать, перечислять
reckless -- отчаянный, безрассудный, опрометчивый
immortal -- бессмертный
impact -- удар (не stroke)
impatience -- нетерпение
impatient -- нетерпеливый
impatiently -- нетерпеливо
impediment -- препятствие
impenetrable -- непроницаемый
imperative -- повелительное наклонение (грам.)
imperfect -- несовершенный
imperial -- Имперский (TR!)
impertinence -- дерзость
implement -- выполнять
implementation -- Выполнение (TR!)
implemented -- Осуществленный (TR!)
implied -- подразумеваемый (i-)
impolite -- невежливый, неучтивый
import -- импорт, ввоз
importance -- важность
important -- важный
impose -- налагать
impossible -- невозможный
impostor -- самозванец, плут
impress -- производить впечатление
impression -- впечатление
impressive -- впечатляющий -ve
imprison -- заключать в тюрьму
improbable -- невероятный
improve -- улучшать
improved -- улучшил (от improve)
improvement -- улучшение
improvements -- Усовершенствования (TR!)
impulse -- побуждение, порыв
impure -- нечистый, грязный, с примесью
in -- в
inability -- неспособность
inaccessible -- недоступный
incessant -- непрерывный, вечный
inch -- дюйм
inches -- Дюймы (TR!)
incident -- инцидент
incidentally -- между прочим
inclination -- склонность
incline -- склонять
inclined -- наклонный
include -- включать
included -- включенный (от include)
including -- включая
inclusion -- включение
income -- доход, заработок
incomprehensible -- непонятный, непостижимый i-
inconsistent -- непоследовательный
inconvenient -- неудобный
incorrect -- неверный, неправильный
increase -- рост
increasing -- возрастающий
increasingly -- все больше и больше
incredible -- невероятно
incur -- подвергаться
indebted -- обязанный
indeed -- неужели, действительно (не really)
indefinite -- неопределенный, неограниченный
independence -- независимость
independent -- независимый
independently -- независимо
index -- индекс, указатель, показатель
indexes -- Индексы (TR!)
indians -- Индусы(индейцы) (TR!)
indicate -- показывать, указывать
indices -- Индексы (не indexes) (TR!)
reckon -- считать
recognition -- узнавание
recognize -- узнавать, узнать
recoil -- отдача, отпрянуть, испытывать ужас
recollect -- припоминать
recollection -- воспоминание (не reminiscence)
recommend -- рекомендовать
recommended -- Рекомендуемый (TR!)
reconnaissance -- разведка
reconstruct -- реконструировать
record -- запись, пластинка, отчет, рекорд
recorded -- Зарегистрированный (TR!)
recorder -- записывающее устройство
recording -- регистрация -ing
records -- пластинки (от record)
recover -- выздоравливать
recovery -- выздоровление
recreate -- Заново создавать, воскрешать, освежиться (TR!)
recruit -- вербовать, нанимать
red -- красный
redeem -- выкупать, искупать, выполнять (обещание и т.п.)
reduce -- уменьшать, понижать, сокращать
reduced -- Уменьшенный (не lowered) (TR!)
reducing -- понижает (от reduce)
reduction -- снижение
reed -- тростник, камыш (не cane)
reeds -- Тростники (не canes) (TR!)
reel -- катушка, барабан (тех.); пошатываться, спотыкаться (не coil)
refer -- отсылать, ссылаться r-
reference -- рекомендация, ссылка, справка
references -- рекомендации (от reference)
referred -- Отнесенный (TR!)
refers -- Обращается(относится) (TR!)
reflect -- отражать, размышлять
reflected -- Отраженный (TR!)
reflecting -- отражающий
reflection -- отражение, размышление
reflections -- Отражения (TR!)
reform -- улучшать, реформа
refrain -- удерживать, сдерживать, воздерживаться
refresh -- освежать
refreshment -- подкрепление
refreshments -- закуски и напитки
refrigerator -- холодильник
refuge -- убежище
refusal -- отказ
refuse -- отказывать
refused -- отказался (от refuse)
regain -- достичь
regard -- взгляд, внимание, смотреть, считать *e-
regarded -- Расцененный (TR!)
regarding -- Относительно *e-ing (TR!)
regardless -- независимо от
regards -- привет, поклон
regiment -- полк
region -- район, область
regions -- Области(регионы) (TR!)
register -- (за)регистрировать
registered -- зарегистрированный, заказной (от register)
registration -- регистрация
registry -- Регистрация(регистратура) (TR!)
regret -- жалеть
regular -- регулярный
regularly -- регулярно
regulate -- регулировать, приспосабливать
rehearsal -- репетиция
reign -- царить, господствовать
reins -- поводья, вожжи
reject -- отвергать
rejection -- отказ
rejoice -- радовать(ся)
rejoined -- Воссоединенный (TR!)
relate -- относиться, связывать
relation -- отношение, связь
relations -- отношения, связи (от relation)
relationship -- родственные связи
relative -- родственник
relax -- ослаблять
relay -- смена (не shift)
release -- освобождение, освобождать
released -- освобожденный
reliable -- надежный
reliance -- доверие, уверенность
relic -- след, остаток, пережиток
relief -- облегчение, утешение
relieve -- облегчать
relieved -- избавленный !NEW!
religion -- религия
religious -- религиозный
relish -- вкус, привкус, смаковать
reluctant -- делающий что-л. с большой неохотой, по принуждению; сопротивляющийся
reluctantly -- неохотно (не unwillingly)
rely -- полагаться, доверять
remain -- оставаться
remainder -- остаток
remained -- оставшийся !NEW!
remains -- Остается (TR!)
remark -- замечать, замечание (не notice)
remarkable -- замечательный  r-
remarkably -- замечательно -y
remarks -- Замечания *e- (TR!)
remedy -- лекарство
remember -- помнить
remembered -- помнил (от remember)
remembrance -- воспоминание, память
remind -- напоминать, напомнить
remiss -- небрежный, вялый
remote -- дистанционный, удаленный
removal -- перемещение r-
remove -- удалять, убирать, перемещать
removed -- удалённый !NEW!
renamed -- Переименованный (TR!)
render -- отдавать
rendered -- Предоставленный (не supplied) (TR!)
renew -- обновлять
renewal -- обновление (не refresh)
renewed -- Возобновленный (не resumed) (TR!)
rent -- брать напрокат, снимать жилье, квартирная плата
renting -- аренда, снятие комнаты -ing
reopen -- возобновлять (не resume)
repair -- ремонтировать, ремонт, починка
repaired -- ремонтировал, отремонтированный (от repair)
repay -- оплачивать
repeat -- твердить, говорить наизусть
repeatedly -- неоднократно
repel -- отталкивать, внушать отвращение
repent -- раскаиваться
repentance -- раскаяние
repetition -- повторение
replace -- заменять, замещать
replacement -- замещение
reply -- отвечать, ответ
report -- доклад, сообщать, рассказывать
reporter -- репортер
reporting -- Сообщение -ing (TR!)
repose -- полагаться, доверяться
represent -- изображать, представлять
representation -- изображение
representative -- представитель
reproach -- упрек, осуждение, упрекать
reproduce -- воспроизводить
reproof -- порицание, выговор (не reprove)
reprove -- порицать, делать выговор
reptile -- пресмыкающееся
republic -- республика
repulse -- отражать (врага), отвергать, отталкивать, отпор
reputation -- репутация
request -- просьба
requested -- Требуемый (TR!)
requests -- просьбы (от request)
require -- требовать
required -- потребованный (не demanded) !NEW!
requirement -- требование
requires -- Требует (TR!)
rescue -- спасение, спасать
research -- исследование
resemblance -- сходство
resemble -- походить
resent -- обижаться, возмущаться *e-
resentment -- возмущение
reservation -- предварительный заказ, резервирование
reserve -- заказывать
reserved -- заказал, заказанный (от reserve)
reservoir -- резервуар
reside -- жить, проживать (r-)
residence -- резиденция
resident -- постоянный житель
residential -- жилой
resign -- уходить в отставку
resignation -- отставка, заявление об отставке, покорность, смирение
resigned -- покорный, безропотный **s-
resist -- сопротивляться
resistance -- сопротивление
resolution -- решение, резолюция, решимость
resolve -- решать
resolved -- решился, принял решение !NEW!
resort -- обращение, обращаться
resource -- ресурс, средство
resources -- Ресурсы (TR!)
respect -- уважение, уважать
respectable -- почтенный, порядочный
respected -- Уважаемый (TR!)
respectful -- почтительный
respective -- соответственный
respectively -- соответственно
respond -- отвечать
responded -- Отвечал (TR!)
response -- реакция, ответ (не reaction)
responsibility -- ответственность
responsible -- ответственный
responsive -- отзывчивый
rest -- остальное, остальные, остаток
restart -- Переначало (TR!)
restaurant -- ресторан
rested -- отдыхал (от rest)
restless -- беспокойный, неугомонный
restoration -- реставрация
restore -- восстанавливать
restrain -- сдерживать
restrict -- ограничивать
restriction -- ограничение
opinion -- мнение
opponent -- соперник
opportunity -- возможность
opposed -- Противопоставленный (TR!)
opposite -- противоположный
opposition -- противодействие
oppressive -- гнетущий, деспотический
opt -- выбирать
option -- выбор (o-)
optional -- Дополнительный (TR!)
options -- Выбора (TR!)
or -- или
orange -- апельсин, оранжевый
oranges -- апельсины (от orange)
orchard -- фруктовый сад
orchestra -- партер, оркестр
order -- порядок, приказ, заказ, заказывать, приказывать
ordered -- приказал (от order)
orderly -- аккуратный
ordinal -- порядковый
ordinarily -- обыкновенным, обычным путем; обычно; нормально; в обычной степени
ordinary -- обычный, простой
organ -- орган
organic -- органический
organization -- организация
organize -- организовывать
organized -- организовывал (от organize)
organizer -- организатор
organs -- Органы (TR!)
oriental -- восточный
origin -- происхождение
original -- оригинал, первоначальный
originally -- первоначально
originate -- возникать, происходить, давать начало, порождать; создавать
ornament -- украшение, орнамент; украшать
orphan -- сирота, сиротский
ostrich -- страус
other -- другой
otherwise -- иначе
ought -- долженствование
our -- наш
ours -- наш
ourselves -- себя, себе, сами
out -- вне, вон, из, снаружи, наружный
outbreak -- взрыв, вспышка, начало (войны и т.п.)
outcome -- результат
outcry -- крик, протест
outdoor -- на открытом воздухе
outer -- внешний
outfit -- снаряжение, обмундирование, оборудование
outlaw -- человек вне закона, изгнанник
outlet -- выход, выходное отверстие
outline -- контур, конспект, план, схема; краткое содержание
output -- выпуск, продукция
outrage -- нарушение закона, насилие, оскорблять
outright -- открыто, прямо; без утайки (не straight, directly)
outside -- снаружи, наружный
outskirts -- окраина (города), опушка (леса)
outstanding -- выдающийся *u-
outward -- внешний, наружный (не outside)
outwit -- перехитрить
oven -- печь
install -- водворять, устраивать, устанавливать
installation -- Установка (TR!)
installed -- Установленный (TR!)
installer -- Монтажник (TR!)
installing -- Монтаж -ing (TR!)
installs -- Устанавливает (TR!)
instance -- пример
instances -- Случаи *n- (TR!)
instant -- мгновение
instantly -- немедленно
instead -- вместо, взамен
instinct -- инстинкт
instinctive -- инстинктивный
institution -- учреждение
instruct -- инструктировать
instruction -- инструкция
instructor -- инструктор
instrument -- инструмент
insufficient -- недостаточный
insult -- оскорбление
insurance -- страхование, страховка
intake -- поглощение
integer -- Целое число (TR!)
integral -- неотъемлемый
intellectual -- интеллигент
intelligence -- интеллект
intelligent -- умный
intend -- намереваться
intended -- предполагаемый i-
intense -- интенсивный, напряженный
intent -- намерение, цель i-
intention -- намерение, замысел
intentional -- умышленный
intentions -- Намерения (TR!)
inspection -- осмотр
inspector -- контролер, инспектор i-
inspiration -- вдохновение
inspired -- Вдохновленный (TR!)
install -- водворять, устраивать, устанавливать
installation -- Установка (TR!)
installed -- Установленный (TR!)
installer -- Монтажник (TR!)
installing -- Монтаж -ing (TR!)
installs -- Устанавливает (TR!)
instance -- пример
instances -- Случаи *n- (TR!)
instant -- мгновение
instantly -- немедленно
instead -- вместо, взамен
instinct -- инстинкт
instinctive -- инстинктивный
institution -- учреждение
over -- через, над, сверх
overall -- всеобщий o-
overcoat -- пальто
overcome -- преодолеть
overflow -- переливаться через край, заливать, переполнять
overhead -- наверху, над головой, верхний
overhear -- подслушивать
overjoyed -- вне себя от радости, очень довольный
overload -- перегружать
overlook -- надзирать
override -- наехать, переехать; задавить Отвергнуть (TR!)
overthrow -- свергать
overtime -- сверхурочные
overturn -- опрокидывать(ся), ниспровергать
overwhelm -- засыпать, забрасывать (вопросами), сокрушать
overwhelming -- несметный
owe -- быть должным
owen -- Оуэн (TR!)
owing -- должный
owl -- сова
own -- иметь, владеть, свой, собственный
owner -- владелец
owners -- Владельцы (TR!)
ownership -- собственность
ox -- бык
oxbow -- ярмо
oxygen -- кислород
oyster -- устрица
oysters -- устрицы (от oyster)
oz -- Унция (TR!)
pace -- шагать
pacific -- мирный
pack -- упаковывать, упаковать
package -- пакет
packet -- пакет (не bundle)
pad -- мягкая прокладка, подушка; подбивать (ватой и т.п.)
paddle -- короткое весло, грести одним веслом; шлепать по воде
padlock -- висячий замок
page -- страница
paid -- платил, оплаченный (от pay)
pail -- ведро
pain -- боль, страдание
painful -- причиняющий боль, мучительный
pains -- боли, страдания (от pain)
paint -- красить, краска
painter -- художник
painting -- живопись
pair -- пара
pairs -- Пары (TR!)
pal -- приятель, товарищ, дружок
palace -- дворец
pale -- бледный
palm -- ладонь
pamphlet -- брошюра, памфлет
pan -- сковорода
pane -- оконное стекло
panel -- комиссия
pang -- острая боль
panic -- паника
pant -- задыхаться (не gasp)
pantomime -- Пантомима (TR!)
pantry -- кладовая, чулан (не closet)
paper -- бумага, газета
parade -- парад
paragraph -- параграф
parallel -- параллельный
parameter -- Параметр (TR!)
parameters -- Параметры (TR!)
parcel -- пакет *a-
parchment -- Пергамент (TR!)
pardon -- извинение
parent -- родитель, родственник
parents -- родители (от parent)
park -- парк, (при)парковать(ся)
parked -- Припаркованный (TR!)
parking -- стоянка
parliament -- парламент
parlor -- Комната (TR!)
parlour -- кабинет p-
parrot -- попугай
parrots -- Попугаи (TR!)
parsley -- петрушка (бот.)
part -- часть, доля, роль, делить, расставаться, расходиться
parted -- Разделенный (TR!)
partial -- частичный
partially -- Частично (TR!)
participate -- участвовать
particles -- Частицы (TR!)
particular -- особый
particularly -- особенно, в особенности
parties -- вечеринки (от party)
parting -- прощание
partition -- разделение
partly -- частично
partner -- участник
parts -- части (от part)
party -- вечеринка, группа
pass -- передавать, проходить, пропуск, перевал
passage -- проход
passages -- проходы !NEW!
passed -- прошел (от pass)
passenger -- пассажир
passengers -- Пассажиры (TR!)
passing -- прохождение
passion -- страсть
passionate -- страстный
password -- Пароль (TR!)
passwords -- Пароли (TR!)
past -- после, за
paste -- тесто, клейстер, паста; клеить, склеивать
pasture -- пастбище
pat -- хлопок
patch -- заплатка
path -- тропинка, беговая дорожка
pathetic -- трогательный
paths -- Дорожки (не roads, lanes) (TR!)
patience -- терпение
patient -- пациент, терпеливый
patiently -- Терпеливо (TR!)
patrol -- патруль
patsy -- Паци (TR!)
patted -- Ласкал (TR!)
pattern -- модель
paul -- пол !NEW!
pause -- пауза
pausing -- Приостановка -ing (TR!)
pavement -- тротуар (не sidewalk)
paw -- лапа
paws -- Лапы (TR!)
pay -- платить, зарплата
paying -- платеж
payment -- плата
pea -- горох
peace -- мир
peaceable -- миролюбивый, мирный
peaceful -- мирный, спокойный
peacefully -- мирно
peach -- персик
peaches -- персики (от peach)
peacock -- павлин
peak -- вершина
peal -- трезвон, раскат грома
peanut -- земляной орех
pear -- груша
pearl -- жемчуг, жемчужный
pearls -- Жемчуг (TR!)
pears -- груши (от pear)
peas -- горошек, горох
pebble -- галька, горный хрусталь
peck -- клевать
peculiar -- особенный p-
peculiarities -- Особенности (TR!)
pedal -- педаль
pedestrian -- пешеход
peeks -- (он) Посмотрит -s (TR!)
peel -- чистить, почистить
peep -- проблеск, выглядывать
peer -- вглядываться, всматриваться p-
peered -- Глядел (*e-) (TR!)
peering -- Глядя -ing (TR!)
peeves -- Обиды (TR!)
peg -- целиться
pen -- ручка
pencil -- карандаш
pending -- во время, в течение
penetrate -- проникать внутрь
penholder -- ручка (для пера)
penknife -- перочинный нож
penny -- пенни
pensioner -- пенсионер
people -- люди
pepper -- перец
per -- в
perceive -- воспринимать, ощущать
perceived -- Воспринятый (TR!)
percent -- процент
percy -- Перси (TR!)
perfect -- совершенный
perfection -- совершенство
perfectly -- совершенно, вполне
perform -- делать, выполнять
performance -- спектакль
performed -- Выполненный (не от слова fulfil) (TR!)
perfume -- духи
perhaps -- возможно, может быть
peril -- опасность
perilous -- опасный, рискованный
period -- период
periodic -- периодический
periods -- Периоды (TR!)
permanent -- постоянный
permanently -- постоянно
permissible -- допустимый
permission -- разрешение
permit -- разрешать
permitted -- Разрешенный (TR!)
perpendicular -- перпендикулярный
perpetual -- вечный, постоянный p-
perry -- Перри (TR!)
persecution -- преследование
perseverance -- настойчивость, упорство
persian -- Персидский (TR!)
persistent -- настойчивый
person -- человек, особа, лицо, личность
personal -- личный
personally -- лично
persons -- Люди (TR!)
perspective -- перспектива, перспективный
persuade -- убеждать
persuaded -- Убежденный (не convinced) (TR!)
perverse -- извращенный, испорченный, превратный
pest -- паразит, вредитель, бич
pet -- любимое домашнее животное, любимец
peter -- Питер (TR!)
petition -- петиция, прошение, подавать петицию
petrol -- бензин
pets -- домашние животные (от pet)
phantom -- Фантом (TR!)
phase -- фаза, фазировать
philadelphia -- Филадельфия (TR!)
philip -- Филип (TR!)
philosophical -- философский
philosophy -- философия
phone -- телефон
phosphate -- Фосфат (TR!)
photo -- фотография
photograph -- фотография, фотографировать
photographer -- фотограф
photographic -- фотографический
photographing -- фотографирование
photography -- фотография
phrase -- фраза
physical -- физический
physically -- физически
physician -- врач
piano -- пианино
pick -- собирать, подбирать, выбирать
picked -- собранный, выбранный !NEW!
restrictions -- ограничения (от restriction)
result -- результат
resume -- итог, сводка, возобновлять, подводить итог
resumed -- Возобновленный (TR!)
retain -- удерживать
retained -- Сохраненный (TR!)
retire -- уходить, удаляться, оставлять должность
retired -- отставной
retirement -- отставка
retiring -- скромный r-
retorted -- Парировал (TR!)
retreat -- отступать, отступление, убежище
return -- вернуть(ся), возвращение
rev -- оборот
reveal -- обнаруживать r-
revealed -- Показанный (TR!)
revenge -- месть, мстить
revenue -- доход
reverence -- почтение, благоговение (не deference)
reverse -- противоположное, обратное r-
reversion -- Возвращение (не returning) (TR!)
revert -- возвращаться (не return)
review -- обзор, смотр (не survey)
revision -- пересмотр
revive -- оживать
revolution -- революция
revolutionary -- революционный, революционер
revolve -- вращаться
reward -- награда
rex -- Рекс (TR!)
rhinoceros -- носорог
rhyme -- рифма, рифмовать
rhythm -- ритм
rib -- ребро (не hip)
ribbon -- лента
rice -- рис
rich -- богатый
richard -- Ричард (TR!)
riches -- богатство, изобилие
rick -- стог, складывать в стог
rid -- освобождать
riddle -- загадка (не enigma)
ride -- езда, прогулка (не пешая), ехать (на поезде, велосипеде и т.п.)
rider -- наездник, всадник
ridge -- горный хребет, гребень (горы и т.п.) (не crest)
ridiculous -- нелепый, смехотворный, смешной
riding -- еду (от ride), верховая езда
rifle -- ружье, винтовка
rift -- трещина, щель, ущелье
rig -- снаряжение, экипаж
right -- правильный, правый
rightly -- справедливо r-
rigid -- жесткий (не tough)
rigorous -- суровый (не severely) r-
rim -- ободок
rind -- кожура, кора, корка (не pool)
ring -- кольцо, звон, звонок, звенеть, звонить
rings -- Кольца (TR!)
rip -- рвать
ripe -- спелый
ripen -- зреть, созревать
rise -- подниматься, восходить, подъем, повышение
risen -- Повышенный (TR!)
rising -- возрастающий
risk -- риск, рисковать
rival -- соперник, соперничающий
river -- река
rivers -- Реки (TR!)
rivulet -- ручеек, речушка
road -- дорога
roam -- бродить, скитаться
roar -- реветь, орать, хохотать
roast -- жареный
rob -- грабить, обворовывать
robber -- грабитель
robbery -- грабеж
robes -- Одежды (TR!)
robin -- малиновка
robot -- Робот (TR!)
robots -- Роботы (TR!)
rochester -- Рочестер (TR!)
rock -- скала
rocky -- скалистый !NEW!
rod -- прут, жезл, удочка
rode -- ехать (2 форма) !NEW!
rogue -- плут, мошенник (не valet)
role -- роль
roll -- вращение, список, булочка, вращаться, катить(ся)
rollback -- Обратная перемотка (TR!)
roller -- ролик
roman -- Католик (TR!)
romance -- романтика, романтическая история
romantic -- романтичный
rome -- Рим (TR!)
ron -- Рон (TR!)
roof -- крыша
room -- комната
rooms -- комнаты (от room)
root -- корень
rope -- канат
ropes -- Веревки (TR!)
rose -- роза
rosy -- розовый, румяный (не pink)
rot -- вздор, нелепость
rotten -- гнилой, отвратительный
rouge -- румяна, губная помада
rough -- грубый
round -- круг, цикл, полный, круглый
rounded -- Округленный (TR!)
rouse -- будить, побуждать (первая буква НЕ a)
roused -- Разбуженный (не awoken) (TR!)
route -- маршрут, путь, направлять
rover -- скиталец, странник
row -- грести
rowing -- гребля, выговор
royal -- королевский (не queen)
rpm -- Оборот в минуту (TR!)
rub -- тереть, стирать, трение
rubber -- резина
rubbing -- Протирка (не от слова wash) -ing (TR!)
rubbish -- ерунда, мусор (не garbage)
ruby -- рубиновый
rudder -- руль
rude -- грубый, резкий, невоспитанный
rudimentary -- Элементарный(рудиментарный) (TR!)
rueful -- унылый
ruffle -- ерошить (волосы), рябить (воду)
rug -- ковер
ruin -- гибель
ruins -- Руины (TR!)
rule -- правило, принцип, норма, управлять, решать
ruler -- линейка, правитель
rules -- правила (от rule)
ruling -- правящий (-ing)
rum -- ром, странный
rumour -- слух, молва
run -- бегать, двигаться, бег, движение, направление
rung -- ступенька, спица колеса
runner -- бегун
runners -- Бегуны (TR!)
running -- пробег, бегущий
runs -- Пробега (TR!)
ruse -- уловка, хитрость
rush -- устремляться, бросаться, мчаться
russell -- Русселл (TR!)
Russia -- Россия
Russian -- русский
rust -- ржавчина, ржаветь
rustle -- шелест, шорох, шелестеть, шуршать r-
rusty -- заржавленный, порыжевший
rut -- колея, привычка
ruth -- жалость, сочувствие, участие, сострадание *u- !NEW!
rye -- рожь
sabotage -- саботаж, саботировать
sack -- мешок
sacred -- священный
sacrifice -- жертва
sad -- печальный
saddle -- седло, седлать
sadly -- печально
sadness -- печаль
safe -- сейф, безопасный, надежный
safeguard -- гарантия s-
safety -- безопасность
said -- сказал (от say)
sail -- парус, плыть
sailor -- матрос
saint -- святой
sake -- ради, для
salad -- салат, винегрет
salary -- оклад
sale -- распродажа
sally -- поездка, прогулка
salmon -- лосось
salt -- соль, соленый, солить
salts -- Соли (TR!)
salute -- приветствовать, салют
salvage -- спасать !NEW!
salvation -- спасение
sam -- Сэм (TR!)
same -- тот же, так(ой) же
sample -- образец
sanction -- санкция
sand -- песок
sandwich -- бутерброд
sandwiches -- Бутерброды (TR!)
sandy -- песчаный
sang -- пел, спел (от sing)
sanguine -- живой, жизнерадостный, румяный (не spirited)
sank -- тонул !NEW!
santos -- Сантус (TR!)
sap -- сок (растений); подрывать
sat -- сидел (от sit)
satisfaction -- удовлетворение
satisfactorily -- удовлетворительно
satisfactory -- удовлетворительный
satisfy -- удовлетворять
Saturday -- суббота
sauce -- соус, приправа, поливать соусом
saucepan -- кастрюля
saucer -- блюдце
sausage -- колбаса, сосиска
savage -- дикарь
savagely -- свирепо, дико s-
save -- спасать, хранить, экономить
saved -- спасал (от save)
saving -- экономия -ing
saviour -- спаситель
savoury -- вкусный, пикантный, приятный
saw -- видел, смотрел (от see)
say -- сказать, говорить
saying -- говорящий (от say)
scaffold -- эшафот
scale -- масштаб
scan -- Просмотр (TR!)
scar -- шрам, рубец
scarce -- редкий, едва (не barely, merely, hardly)
scarcely -- едва sc-
scare -- испуг
scared -- напуганный !NEW!
scarf -- шарф
scarlet -- алый
scatter -- разбрасывать, рассеивать
scattered -- Разбросанный, раскиданный (TR!)
scene -- действие, картина, сцена
scenery -- декорации
scenes -- сцены, эпизоды (от scene)
scent -- запах, духи, след, почуять, нюхать (не smell)
schedule -- расписание, таблица, планировать
scheme -- проект
schemes -- Схемы (TR!)
scholar -- ученый
scholars -- Ученые (TR!)
school -- школа, обучать
schoolboy -- школьник
schoolmaster -- учитель
science -- наука, умение
scientific -- научный
scientist -- ученый
scissors -- ножницы
scold -- бранить, ругать
scope -- пределы
score -- счет, отметка, выигрывать
scorn -- презрение, презирать
scornful -- презрительный
scotch -- надрез, метка, уничтожать
scoundrel -- негодяй
scout -- разведчик
scowled -- Хмурился (не от слова frown) (TR!)
scramble -- карабкаться
scrambled -- Боролся(взбирался) (TR!)
scrap -- клочок, кусочек, отрывок
scratch -- царапать
scratched -- Поцарапанный (TR!)
scream -- вскрикнуть, зареветь, визг, вопль (не shriek)
screen -- экран, перегородка, прикрывать
screw -- привинчивать, завинчивать, принуждать, винт
scribble -- каракули, писать неразборчиво
script -- сценарий
scripts -- Подлинники(сценарии) (TR!)
scrub -- тереть
scuba -- Акваланг (TR!)
scuffle -- драка, потасовка
sculpture -- скульптура
sea -- море, океан
seal -- печать, запечатывать
seam -- шов
seaman -- моряк *e-
search -- искать, обыскивать, поиск, обыск
seasick -- страдающий морской болезнью
seaside -- морское побережье
season -- время года, сезон, созревать
seat -- место, сиденье, сажать, усаживать
seated -- Помещенный (TR!)
seats -- места (от seat)
seaweed -- Морская водоросль (TR!)
second -- второй, помощник, секунда
secondary -- средний, второстепенный
secondly -- Во-вторых (TR!)
secret -- секрет
secretary -- секретарь
secretion -- Укрывательство (TR!)
section -- отделение, делить на части s-
secure -- страховать s-
security -- безопасность
sedate -- спокойный
see -- (у)видеть, встретиться
seed -- семя, семена
seedling -- Рассада (TR!)
seedlings -- Рассада (TR!)
seeds -- Семена (TR!)
seeing -- видящий (от see)
seek -- искать (не find)
seem -- казаться
seeming -- видимый, мнимый (не visible)
seen -- увиденный (от see)
segment -- Доля (не portion, section) (TR!)
seize -- хватать -e
seized -- захваченный !NEW!
seldom -- редко
select -- выбирать, сортировать, избранный
selected -- Отобранный (TR!)
selection -- отбор
self -- сам, себя
selfish -- эгоистичный
sell -- продавать, торговать
seller -- торговец (не trader)
selling -- продажа
semi -- Полу (TR!)
semicolon -- точка с запятой
send -- отправлять, посылать
senior -- старший s-
sensation -- чувство s-
sense -- чувство, здравый смысл, чувствовать
senses -- Чувства (TR!)
sensible -- разумный
sensitive -- чувствительный
sensitiveness -- Чувствительность (TR!)
sent -- отправил, послал, отправленный, посланный (от send)
sentence -- предложение s-
sentiment -- настроение
sentiments -- Чувства (TR!)
separate -- отдельный
separated -- Отделенный (TR!)
separation -- отделение, разделение
September -- сентябрь
sequel -- продолжение, результат
sequence -- последовательность
sergeant -- сержант
series -- серия
serious -- серьезный
seriously -- серьезно
sermon -- проповедь
serpent -- змея, змей
servant -- слуга
serve -- служить, обслуживать, подавать
server -- Прислуга (TR!)
servers -- Прислуга (TR!)
service -- сервис, обслуживание
services -- Услуги (TR!)
serving -- порция s-ing
session -- заседание (не sitting)
set -- класть, ставить, помещать, комплект
sets -- декорации (от set)
setting -- окружение -ing
settle -- поселять, устраивать, оплачивать
settlement -- поселение
seven -- семь
seventeen -- семнадцать
seventh -- седьмой
seventy -- семьдесят
several -- несколько
severe -- суровый, жестокий (s-)
severely -- строго (*e-)
sew -- шить
sex -- пол
sexual -- сексуальный
shabby -- потрепанный, поношенный
shade -- оттенок, тень, затенять
shades -- оттенки (от shade)
shadow -- тень, покров, заслонять
shady -- тенистый, сомнительный, темный
shaft -- древко, ручка, рукоятка, вал (тех.)
shaggy -- лохматый
shake -- пожать (руки), дрожать, трясти
shall -- модальный глагол долженствования
shallow -- мелкий, поверхностный, (от)мель
sham -- притворство, обман
shame -- стыд, стыдить, стыдиться
shape -- форма
shaped -- Форменный (TR!)
shapeless -- бесформенный
share -- разделять, доля, часть
shark -- акула
sharp -- точно, ровно, резкий, крутой, плутовать
sharpen -- точить
sharply -- резко
shave -- (по)бриться, бритье, подстригать
shaving -- бритье (-ing)
shawl -- платок, шаль
she -- она
shed -- сарай
sheep -- овца, овцы
sheer -- настоящий
sheet -- простыня, лист, пласт
shelf -- полка
shell -- раковина, скорлупа
shells -- Снаряды(раковины) (TR!)
shelter -- приют, убежище
shelves -- Полки (TR!)
shepherd -- пастух
sheriff -- Шериф (TR!)
shield -- щит
shift -- смена, перемещать
shilling -- шиллинг
shindy -- шум, скандал
shine -- сиять, светить
shiny -- Солнечный (не sunny) (TR!)
ship -- корабль, пароход, грузить, перевозить
shipwreck -- кораблекрушение
shirt -- рубашка, блузка
shiver -- дрожать, дрожь, трепет s-
shock -- удар s-
shocking -- потрясающий
shoe -- ботинок, туфля
shoemaker -- сапожник
shoes -- обувь, туфли (от shoe)
shone -- сиял, блестел !NEW!
shook -- трёс !NEW!
shoot -- стрелять, застрелить
shooting -- Стрельба (TR!)
shop -- магазин, мастерская
shopping -- делать покупки
shops -- магазины (от shop)
shore -- берег
short -- короткий, слабый, внезапно
shorter -- короче (от short)
shortest -- ближайший, самый короткий (от short)
shorthand -- стенография
shortly -- вскоре
shorts -- трусики
shot -- попытка, выстрел
should -- следует (от shall)
shoulder -- плечо, толкать
shout -- кричать, крик
shove -- толкать(ся), пихать, толчок
shoved -- Пихал (не popped) (TR!)
shovel -- лопата
show -- показывать, демонстрировать, выставка, зрелище
showed -- показал (от show)
shower -- душ, ливень
shown -- Показанным (TR!)
shrewd -- проницательный, ловкий (делец)
shriek -- кричать, вскрикнуть, пронзительный крик (не scream)
shrill -- резкий, пронзительный
shrimp -- креветка
shrine -- сохранять
shrink -- отпрянуть, садиться (о материи)
shrub -- куст
shrubs -- кусты (не bushes) !NEW!
shrug -- пожимать плечами
shrugged -- Пожал (TR!)
shudder -- дрожь, вздрагивать; содрогаться
shuffle -- шаркать
shut -- закрывать, запирать, замолчать
shutdown -- Закрытие (TR!)
shutter -- ставень, затвор
shy -- застенчивый, робкий
sibilant -- шипящий звук
sick -- больной
sickly -- болезненный, нездоровый, тошнотворный
sickness -- болезнь, заболевание
side -- сторона, бок, край
sidenote -- Заметка на полях (TR!)
sideways -- боком, косвенно
sierra -- горная цепь
sieve -- решето, сито
sigh -- вздыхать, вздох
sight -- зрелище, вид, заметить, разглядеть
sights -- достопримечательности
sign -- подписывать(ся), знак, вывеска
signal -- сигнал, сигнализировать
signature -- подпись
signed -- Подписанный (TR!)
significance -- значение
significant -- значительный s-
significantly -- значительно
signify -- значить, означать, иметь значение
signs -- знаки, вывески (от sign)
silas -- Силас (TR!)
silence -- молчание, тишина
silent -- молчаливый, бесшумный
silk -- шелковый, шелк
sill -- подоконник
silly -- глупый
silver -- серебро, серебряный
similar -- похожий
similarly -- также
simple -- простой, однозначный
simplicity -- Простота (-t*) (TR!)
simply -- просто, абсолютно
simulator -- симулянт
simultaneous -- одновременный
simultaneously -- одновременно
sin -- грех, (со)грешить
since -- с тех пор как
sincere -- искренний (-e)
sincerely -- Искренне (не earnestly) (TR!)
sing -- пение, петь
singing -- Пение (TR!)
single -- один, одинокий s-
singular -- странный, необычный, единственное число (грам.)
sinister -- зловещий s-
sink -- тонуть
sinking -- погружение
sir -- сэр
sire -- Родитель (TR!)
sister -- сестра
sit -- сидеть, заседать, годиться
site -- местоположение
sitting -- заседание
situated -- расположенный
situation -- положение
six -- шесть
sixpence -- сумма в 6 пенсов
sixteen -- шестнадцать
sixth -- шестой
sixty -- шестьдесят
size -- размер, величина, измерить
skeleton -- скелет, остов
sketch -- эскиз
ski -- ходить на лыжах
skiing -- катание на лыжах
skilful -- квалифицированный, умелый, ловкий
skill -- мастерство
skilled -- квалифицированный, умелый, ловкий
skim -- просматривать, скользить
skin -- кожа
skinner -- погонщик !NEW!
skinny -- худой, тощий, кожа да кости !NEW!
skins -- Кожи (TR!)
skip -- пропускать (часто бывает при устано !NEW!
skirt -- юбка
skull -- череп
sky -- небо
slab -- плита
slack -- ленивый, слабый, ослаблять, утихать
slacken -- ослаблять, ослабевать
slam -- хлопать, хлопнуть -m
slammed -- Хлопнул (TR!)
slang -- жаргон
slant -- наклонный
slap -- хлопать
slaughter -- резня, убой, резать, убивать
slave -- раб
slaves -- рабы !NEW!
sledge -- ехать на санях
sleek -- гладкий, приглаживать
sleep -- спать, сон
sleepy -- сонный, сонливый (не asleep)
sleeve -- рукав
sleigh -- сани, салазки
slender -- тонкий, стройный
slept -- спал (от sleep)
slice -- ломоть
slid -- скользить (не slip) !NEW!
slide -- скользить
slight -- проявление пренебрежительного равнодушия;неуважение, пренебрежение, игнорирование
slightest -- малейший (от slight)
slightly -- слегка
slim -- стройный
slime -- слизь, липкая грязь, ил; комбинация (белье)
slip -- скольжение, скользить -p
slippery -- скользкий
slogan -- лозунг
slope -- склон, наклон, гора для катания
slow -- медленный, замедлять
slower -- медленнее (от slow)
slowly -- медленно
slumber -- сон, дремота, дремать
sly -- хитрый
smack -- рыболовное судно
small -- маленький, тонкий, скромный
smallest -- Самый маленький (TR!)
smart -- изящный (не grace)
smartly -- ловко
smash -- бить, разбивать
smashed -- Разбитый (TR!)
smear -- масляное пятно, пачкать, мазать
smell -- запах
smelt -- плавить
smile -- улыбаться, улыбка
smiles -- Улыбки (TR!)
smoke -- курить, курение, дым
smoked -- курил (от smoke)
smoker -- курящий, вагон для курящих
smoking -- курение
smooth -- гладкий
smoothly -- гладко !NEW!
snack -- закуска, часть, доля
snake -- змея
snap -- щелкать (snap)
snapped -- Сфотографированный (TR!)
snare -- ловушка
snarl -- рычать, огрызаться; рычание, ворчание
snatch -- схватить
sneer -- усмешка, насмешка; насмехаться, издеваться
sneeze -- чихать, чиханье
sniff -- фыркать, сопеть
sniffed -- Фыркал (TR!)
sniffing -- Фыркающий (TR!)
snigger -- хихикать, хихиканье s-
snoop -- подсматривать !NEW!
snore -- храпеть, храп
snorted -- Фыркал (не от слова sniff) (TR!)
snow -- снег, падать (о снеге)
snowman -- снежная баба
snuff -- Нюхнуть (TR!)
so -- так, таким образом, итак
soap -- мыло
sob -- рыдание
sobbing -- Рыдание (TR!)
sober -- трезвый
sociable -- общительный
social -- общественный
society -- общество
sock -- носок
socket -- патрон (эл. лампочки), глазная впадина
socks -- носки (от sock)
sofa -- диван
soft -- мягкий, тихий (не calm)
soften -- смягчать(ся)
softened -- Смягченный (TR!)
softly -- мягко, нежно
software -- Программное обеспечение (TR!)
soil -- почва
sold -- продавал, проданный (от sell)
solder -- паять
soldier -- солдат
sole -- подошва, подметка; ставить подметку
solely -- Исключительно (TR!)
solemn -- серьезный, торжественный
solemnly -- торжественно
solid -- твердый
solitary -- одинокий, уединенный
solitude -- одиночество, уединение
solution -- решение, разрешение
solve -- (раз)решать
some -- немного, несколько
somehow -- как-нибудь, так или иначе !NEW!
sometimes -- иногда
somewhat -- что-то, отчасти !NEW!
somewhere -- где-нибудь !NEW!
son -- сын
song -- песня
sons -- сыновья (от son)
soon -- скоро, рано
sooner -- охотнее (от soon)
soot -- сажа
soothe -- успокаивать, утешать, облегчать (боль)
soothing -- Успокаивающий -ing (TR!)
sophia -- София (TR!)
sophisticated -- сложный
sore -- больной, воспаленный (не sick)
sorrow -- печаль
sorrowful -- печальный, скорбный
sorry -- сожалеющий, печальный, унылый
sort -- сорт, род, вид, сортировать
sorting -- Сортировка (TR!)
sought -- Искавший(разысканный) (TR!)
soul -- душа, воплощение
souls -- Души (TR!)
sound -- звук, звучать, играть
sounding -- звучащий
sounds -- звучит (от sound)
soup -- суп
sour -- раздражительный, сердитый, кислый
source -- источник
South -- юг
southern -- южный
souvenir -- сувенир
souvenirs -- сувениры (от souvenir)
sovereign -- суверенный
soviet -- Советский (TR!)
sow -- сеять
space -- пространство, место, космос
spacious -- просторный, обширный
spade -- лопата, заступ
spare -- уделять, лишний, запасный
spared -- Сэкономленный (TR!)
spark -- искра
sparkle -- сверкать, искриться
sparkler -- Бриллиант (TR!)
sparrow -- воробей
spasmodic -- судорожный
spat -- размолвка, звонкий удар
speak -- говорить, убеждать
speaker -- оратор
speaking -- говоря(щий) (от speak)
speaks -- Говорит (TR!)
spear -- дротик, копье
special -- специальный, особенный
specialist -- специалист
speciality -- фирменное блюдо
specialize -- специализировать
specially -- особенно
species -- порода
specific -- специфический
specifically -- специфически
specification -- Спецификация (TR!)
specified -- Указанный (TR!)
specify -- точно определять, устанавливать, предписывать; детально излагать
specimen -- образец
specimens -- Экземпляры, образцы (TR!)
spectacle -- зрелище
spectacles -- очки
spectacular -- производящий глубокое впечатление; впечатляющий; эффектный
speculation -- размышление
speech -- речь
speechless -- безмолвный
speed -- скорость, ускорять, спешить
speedily -- быстро
speedometer -- спидометр
speedy -- быстрый, скорый
spell -- писать или произносить (слово) по буквам
spelling -- орфография, правописание
spend -- тратить
spends -- проводит (время) (от spend)
spent -- проводил, тратил, проведенный, потраченный (от spend)
sphere -- сфера
spider -- паук
spiders -- Пауки (TR!)
spike -- острие !NEW!
spill -- проливать(ся), рассыпать(ся)
spin -- прясть, крутить(ся)
spine -- позвоночный столб
spirit -- дух
spirited -- живой, бойкий
spirits -- души !NEW!
spit -- плеваться, фыркать
spite -- злость
spiteful -- злобный
splash -- брызгать(ся), забрызгать, плескать(ся); плеск, брызги
splendid -- замечательно
splinter -- щепка, осколок, заноза
split -- раскалывать
spoil -- портить, баловать
spoke -- говорил, говоривший (от speak)
spoken -- сказанный !NEW!
sponsorship -- попечительство
spoon -- ложка
spoons -- ложки (от spoon)
sport -- спорт, заниматься спортом
sporting -- спортивный (-ing)
sports -- спорт, спортивные соревнования (от sport)
sportsman -- спортсмен
spot -- пятно
spotless -- безупречный
spots -- Пятна(места) (TR!)
spotted -- Определенный *p- (TR!)
spout -- носик (посуды), желоб
sprang -- Прыгал (от слова spring) (TR!)
spray -- брызги, обрызгивать
spread -- распространяться
spreading -- Распространение -ing (TR!)
spree -- веселье, шалость *p-
spring -- весна
sprout -- пускать ростки; отросток, побег
spruce -- Ель (TR!)
sprung -- Прыгал (от слова spring) (TR!)
spur -- стимул
spurt -- бить струей, делать внезапное усилие
spy -- шпион, шпионить
squad -- команда
squadron -- эскадрон, эскадра (мор.)
squall -- писк, визг
square -- площадь, квадратный
squeal -- Визг -a* (TR!)
squeeze -- выжимать, сжимать, давить, впихивать, сжатие, давка
squeezed -- Сжатый (TR!)
squint -- косоглазие, косить (о глазах)
squirrel -- белка
st -- C- (TR!)
stability -- устойчивость
stable -- конюшня
stack -- стог, куча, груда
stadium -- стадион
staff -- штат, персонал, штаб
stage -- сцена, эстрада, ставить
stagger -- шатание, шатать
staggered -- Пораженный *t- (TR!)
stain -- пятно, пятнать, пачкать
stair -- лестница
staircase -- лестница
stake -- ставка, делать ставку
stale -- черствый, затхлый
stalk -- стебель
stall -- партер
stalls -- кресла в партере ( от stall)
stammer -- заикаться, запинаться
stamp -- марка, печать, штемпелевать
stamps -- марки (от stamp)
stand -- остановка, позиция, стенд, киоск, стоять, останавливаться
standard -- стандарт
standing -- репутация, вес, положение в обществе, стоящий (-ing)
standstill -- застой (не stagnation)
star -- звезда
stare -- пристальный взгляд
stared -- пристальный !NEW!
starling -- скворец
start -- начинать, отправляться s-
starter -- стартер
startle -- испугать, сильно удивить
starts -- Запуски (TR!)
starve -- умирать от голода
state -- государство, состояние
stated -- зафиксированный, высказанный, изложенный Заявленный (TR!)
stately -- величавый, величественный
statement -- утверждение, заявление
statements -- Утверждения(заявления) (TR!)
states -- Государства (TR!)
opinion -- мнение
opponent -- соперник
opportunity -- возможность
opposed -- Противопоставленный (TR!)
opposite -- противоположный
opposition -- противодействие
oppressive -- гнетущий, деспотический
opt -- выбирать
option -- выбор (o-)
optional -- Дополнительный (TR!)
options -- Выбора (TR!)
or -- или
orange -- апельсин, оранжевый
oranges -- апельсины (от orange)
orchard -- фруктовый сад
orchestra -- партер, оркестр
order -- порядок, приказ, заказ, заказывать, приказывать
ordered -- приказал (от order)
orderly -- аккуратный
ordinal -- порядковый
ordinarily -- обыкновенным, обычным путем; обычно; нормально; в обычной степени
ordinary -- обычный, простой
organ -- орган
organic -- органический
organization -- организация
organize -- организовывать
organized -- организовывал (от organize)
organizer -- организатор
organs -- Органы (TR!)
oriental -- восточный
origin -- происхождение
original -- оригинал, первоначальный
originally -- первоначально
originate -- возникать, происходить, давать начало, порождать; создавать
ornament -- украшение, орнамент; украшать
orphan -- сирота, сиротский
ostrich -- страус
other -- другой
otherwise -- иначе
ought -- долженствование
our -- наш
ours -- наш
ourselves -- себя, себе, сами
out -- вне, вон, из, снаружи, наружный
outbreak -- взрыв, вспышка, начало (войны и т.п.)
outcome -- результат
outcry -- крик, протест
outdoor -- на открытом воздухе
outer -- внешний
outfit -- снаряжение, обмундирование, оборудование
outlaw -- человек вне закона, изгнанник
outlet -- выход, выходное отверстие
outline -- контур, конспект, план, схема; краткое содержание
output -- выпуск, продукция
outrage -- нарушение закона, насилие, оскорблять
outright -- открыто, прямо; без утайки (не straight, directly)
outside -- снаружи, наружный
outskirts -- окраина (города), опушка (леса)
outstanding -- выдающийся *u-
outward -- внешний, наружный (не outside)
outwit -- перехитрить
oven -- печь
over -- через, над, сверх
overall -- всеобщий o-
overcoat -- пальто
overcome -- преодолеть
overflow -- переливаться через край, заливать, переполнять
overhead -- наверху, над головой, верхний
overhear -- подслушивать
overjoyed -- вне себя от радости, очень довольный
overload -- перегружать
overlook -- надзирать
override -- наехать, переехать; задавить Отвергнуть (TR!)
overthrow -- свергать
overtime -- сверхурочные
overturn -- опрокидывать(ся), ниспровергать
overwhelm -- засыпать, забрасывать (вопросами), сокрушать
overwhelming -- несметный
owe -- быть должным
owen -- Оуэн (TR!)
owing -- должный
owl -- сова
own -- иметь, владеть, свой, собственный
owner -- владелец
owners -- Владельцы (TR!)
ownership -- собственность
ox -- бык
oxbow -- ярмо
oxygen -- кислород
oyster -- устрица
oysters -- устрицы (от oyster)
oz -- Унция (TR!)
pace -- шагать
pacific -- мирный
pack -- упаковывать, упаковать
package -- пакет
packet -- пакет (не bundle)
pad -- мягкая прокладка, подушка; подбивать (ватой и т.п.)
paddle -- короткое весло, грести одним веслом; шлепать по воде
padlock -- висячий замок
page -- страница
paid -- платил, оплаченный (от pay)
pail -- ведро
pain -- боль, страдание
painful -- причиняющий боль, мучительный
pains -- боли, страдания (от pain)
paint -- красить, краска
painter -- художник
painting -- живопись
pair -- пара
pairs -- Пары (TR!)
pal -- приятель, товарищ, дружок
palace -- дворец
pale -- бледный
palm -- ладонь
pamphlet -- брошюра, памфлет
pan -- сковорода
pane -- оконное стекло
panel -- комиссия
pang -- острая боль
panic -- паника
pant -- задыхаться (не gasp)
pantomime -- Пантомима (TR!)
pantry -- кладовая, чулан (не closet)
paper -- бумага, газета
parade -- парад
paragraph -- параграф
parallel -- параллельный
parameter -- Параметр (TR!)
parameters -- Параметры (TR!)
parcel -- пакет *a-
parchment -- Пергамент (TR!)
pardon -- извинение
parent -- родитель, родственник
parents -- родители (от parent)
park -- парк, (при)парковать(ся)
parked -- Припаркованный (TR!)
parking -- стоянка
parliament -- парламент
parlor -- Комната (TR!)
parlour -- кабинет p-
parrot -- попугай
parrots -- Попугаи (TR!)
parsley -- петрушка (бот.)
part -- часть, доля, роль, делить, расставаться, расходиться
parted -- Разделенный (TR!)
partial -- частичный
partially -- Частично (TR!)
participate -- участвовать
particles -- Частицы (TR!)
particular -- особый
particularly -- особенно, в особенности
parties -- вечеринки (от party)
parting -- прощание
partition -- разделение
partly -- частично
partner -- участник
parts -- части (от part)
party -- вечеринка, группа
pass -- передавать, проходить, пропуск, перевал
passage -- проход
passages -- проходы !NEW!
passed -- прошел (от pass)
passenger -- пассажир
passengers -- Пассажиры (TR!)
passing -- прохождение
passion -- страсть
passionate -- страстный
password -- Пароль (TR!)
passwords -- Пароли (TR!)
past -- после, за
paste -- тесто, клейстер, паста; клеить, склеивать
pasture -- пастбище
pat -- хлопок
patch -- заплатка
path -- тропинка, беговая дорожка
pathetic -- трогательный
paths -- Дорожки (не roads, lanes) (TR!)
patience -- терпение
patient -- пациент, терпеливый
patiently -- Терпеливо (TR!)
patrol -- патруль
patsy -- Паци (TR!)
patted -- Ласкал (TR!)
pattern -- модель
paul -- пол !NEW!
pause -- пауза
pausing -- Приостановка -ing (TR!)
pavement -- тротуар (не sidewalk)
paw -- лапа
paws -- Лапы (TR!)
pay -- платить, зарплата
paying -- платеж
payment -- плата
pea -- горох
peace -- мир
peaceable -- миролюбивый, мирный
peaceful -- мирный, спокойный
peacefully -- мирно
peach -- персик
peaches -- персики (от peach)
peacock -- павлин
peak -- вершина
peal -- трезвон, раскат грома
peanut -- земляной орех
pear -- груша
pearl -- жемчуг, жемчужный
pearls -- Жемчуг (TR!)
pears -- груши (от pear)
peas -- горошек, горох
pebble -- галька, горный хрусталь
peck -- клевать
peculiar -- особенный p-
peculiarities -- Особенности (TR!)
pedal -- педаль
pedestrian -- пешеход
peeks -- (он) Посмотрит -s (TR!)
peel -- чистить, почистить
peep -- проблеск, выглядывать
peer -- вглядываться, всматриваться p-
peered -- Глядел (*e-) (TR!)
peering -- Глядя -ing (TR!)
peeves -- Обиды (TR!)
peg -- целиться
pen -- ручка
pencil -- карандаш
pending -- во время, в течение
penetrate -- проникать внутрь
penholder -- ручка (для пера)
penknife -- перочинный нож
penny -- пенни
pensioner -- пенсионер
people -- люди
pepper -- перец
per -- в
perceive -- воспринимать, ощущать
perceived -- Воспринятый (TR!)
percent -- процент
percy -- Перси (TR!)
perfect -- совершенный
perfection -- совершенство
perfectly -- совершенно, вполне
perform -- делать, выполнять
performance -- спектакль
performed -- Выполненный (не от слова fulfil) (TR!)
perfume -- духи
perhaps -- возможно, может быть
peril -- опасность
perilous -- опасный, рискованный
period -- период
periodic -- периодический
periods -- Периоды (TR!)
permanent -- постоянный
permanently -- постоянно
permissible -- допустимый
permission -- разрешение
permit -- разрешать
permitted -- Разрешенный (TR!)
perpendicular -- перпендикулярный
perpetual -- вечный, постоянный p-
perry -- Перри (TR!)
persecution -- преследование
perseverance -- настойчивость, упорство
persian -- Персидский (TR!)
persistent -- настойчивый
person -- человек, особа, лицо, личность
personal -- личный
personally -- лично
persons -- Люди (TR!)
perspective -- перспектива, перспективный
persuade -- убеждать
persuaded -- Убежденный (не convinced) (TR!)
perverse -- извращенный, испорченный, превратный
pest -- паразит, вредитель, бич
pet -- любимое домашнее животное, любимец
peter -- Питер (TR!)
petition -- петиция, прошение, подавать петицию
petrol -- бензин
pets -- домашние животные (от pet)
phantom -- Фантом (TR!)
phase -- фаза, фазировать
philadelphia -- Филадельфия (TR!)
philip -- Филип (TR!)
philosophical -- философский
philosophy -- философия
phone -- телефон
phosphate -- Фосфат (TR!)
photo -- фотография
photograph -- фотография, фотографировать
photographer -- фотограф
photographic -- фотографический
photographing -- фотографирование
photography -- фотография
phrase -- фраза
physical -- физический
physically -- физически
physician -- врач
piano -- пианино
pick -- собирать, подбирать, выбирать
picked -- собранный, выбранный !NEW!
statesman -- государственный деятель
station -- станция, место, размещать
stationery -- писчебумажные принадлежности
statistics -- статистика
statue -- статуя, памятник
stature -- рост *t-
status -- статус
statute -- закон, устав
stay -- оставаться, жить (временно)
stayed -- остался (от stay)
staying -- остающийся, живущий (от stay)
steadily -- неуклонно
steady -- прочный
steak -- бифштекс
steal -- (с)воровать
stealing -- Кража (TR!)
steam -- пар
steel -- сталь
steep -- крутой (не sharp)
steer -- править (рулём)
stem -- стержень
stems -- Стебли (TR!)
step -- шаг, шагать (step)
stepfather -- отчим
stephen -- Стивен (TR!)
sterile -- бесплодный !NEW!
sterility -- Бесплодие (TR!)
stern -- строгий
sternly -- строго !NEW!
steve -- Стив (TR!)
stew -- тушеное мясо
stick -- палка, приставать
sticking -- торчащий, приклеенный (-ing) !NEW!
sticks -- Палки (TR!)
sticky -- липкий, клейкий
stiff -- негнущийся, застывший, холодный, натянутый
stiffen -- (о)коченеть, (о)деревенеть
still -- все еще, однако, тихий
stir -- суета, суматоха, мешать, помешивать, волновать
stitch -- стежок, петля (в вязании), шить
stock -- запас, снабжать (не spare, hoard)
stocking -- чулок
stockings -- чулки (от stocking)
stocks -- Акции(запасы) (TR!)
stocky -- коренастый, низкий, приземистый !NEW!
stolen -- украденный (от steal)
stomach -- живот, желудок
stone -- камень
stool -- табуретка
stoop -- наклонять(ся), нагибать(ся), сутулиться, горбиться
stooped -- Наклоненный (TR!)
stop -- остановка, перестать, остановиться
stoppage -- остановка, задержка
stopped -- остановились (от stop)
stopper -- пробка, затычка
stops -- остановки (от stop)
storage -- хранение *t-
store -- магазин, имущество, запасать, снабжать
stored -- Запасенный (TR!)
storey -- этаж
stories -- истории, рассказы (от story)
stork -- аист
storm -- буря, взрыв (не blast)
stormy -- бурный
story -- рассказ, история
stout -- тучный, дородный
stove -- печь, плита
straight -- прямо, сразу, прямой, достоверный s-
straighten -- выпрямлять(ся)
straightened -- Выправляемый (TR!)
straightforward -- прямой
strain -- натягивать, напрягать(ся), напряжение
strait -- узкий, пролив, затруднительное материальное положение, нужда
strange -- странный
strangely -- странным образом
stranger -- незнакомец, иностранец
strangers -- Незнакомцы (TR!)
strangle -- задушить
strap -- ремень, стягивать ремнем
strategy -- стратегия
straw -- пустяк, мелочь
strawberries -- клубника
strawberry -- земляника
stray -- сбиваться с пути, заблудившийся
stream -- ручей, поток
street -- улица
strength -- численность, сила, прочность
strengthen -- усиливать, укреплять
stretch -- растягивать, вытягиваться
stretched -- растянутый !NEW!
stretching -- Протяжение (TR!)
strict -- точный
strictly -- строго *t-
strike -- ударять, забастовка
striking -- бьющий, ударяющий (от strike)
string -- вереница, ряд, струна, связывать
strings -- Вереницы(нити) (не threads) (TR!)
strip -- полоса
striped -- полосатый
stripes -- Полосы (TR!)
strode -- походка, большой шаг (прошедшее время) !NEW!
stroke -- удар, гладить *t
stroll -- прогулка, гулять
strong -- сильный
strongest -- Самый сильный (TR!)
stronghold -- крепость, оплот
strongly -- решительно (первая буква НЕ "d")
struck -- забастовка, удар (прошедшее время) !NEW!
structure -- структура
struggle -- бороться, борьба
struggling -- Борьба (TR!)
stubborn -- упрямый
stuck -- воткнул, приклеил !NEW!
stud -- запонка
student -- студент
students -- студенты (от student)
studied -- учился (от study)
studio -- студия
studious -- прилежный s-
study -- учиться, изучать, заниматься, исследование, кабинет
studying -- занимается (от study)
stuff -- вещество, материал, заполнять, набивать
stuffed -- Наполненный (TR!)
stuffy -- душный
stumbled -- Наткнулся (TR!)
stump -- пень
stun -- оглушать
stupid -- глупый
style -- стиль, фасон, прическа
subdued -- подавленный
subject -- предмет, содержание, подчинять
subjected -- Подвергнутый *u- (TR!)
subjects -- предметы (от subject)
submarine -- подводная лодка
submit -- подчиняться
subqueries -- Подвопросы (TR!)
subquery -- Подвопрос (TR!)
subscribe -- подписываться
subscriber -- подписчик
subscription -- подписка
subsequent -- последующий (не successive)
subsequently -- впоследствии
subsided -- Спадал (TR!)
substance -- вещество
substantial -- существенный, заметный, прочный, крепкий
substitute -- заместитель
subtle -- тонкий, неуловимый
suburb -- пригород, окраина
succeed -- достигать цели
succeeding -- Следование -ing (TR!)
success -- успех, удача
successes -- успехи (от success)
successful -- удачный, успешный
successfully -- успешно
succession -- последовательность
successive -- последующий
successor -- преемник
such -- такой
suck -- сосать
sudden -- внезапный
suddenly -- внезапно, вдруг
sue -- преследовать судебным порядком, возбуждать дело в суде
suffer -- страдать
suffering -- страдание
sufficient -- достаточный
sufficiently -- достаточно
suffix -- суффикс (грам.)
suffocate -- душить, задыхаться
sugar -- сахар
suggest -- предлагать, советовать
suggested -- предлагал, предложенный (от suggest)
suggestion -- предложение
suggestions -- предложения (от suggestion)
suicide -- самоубийство, самоубийца
suit -- костюм, подходить, устраивать
suitable -- подходящий, соответствующий (не eligible)
suitcase -- чемодан
suitcases -- чемоданы (от suitcase)
suite -- номер люкс
suited -- Удовлетворенный (TR!)
sulky -- мрачный, хмурый **l**
sulphur -- сера
sultry -- знойный, душный
sum -- сумма, подводить итог
summary -- конспект, суммарный
summer -- лето, летний
summit -- вершина
summon -- вызывать
summoned -- Вызванный (TR!)
sun -- солнце
Sunday -- воскресенье
sunflower -- подсолнух
sunk -- Погруженным (TR!)
sunlight -- солнечный свет
sunny -- солнечный
sunrise -- восход солнца
sunset -- закат
sunshine -- солнечный свет
sunstroke -- солнечный удар
superb -- превосходный (не pretty)
superficial -- поверхностный, внешний
superfluous -- излишний, чрезмерный
superintend -- надзирать (за)
superintendent -- управляющий, заведующий
superior -- высший, лучший
superiority -- старшинство
superlative -- превосходная степень (грам.)
supermarket -- супермаркет
superserver -- Суперприслуга (TR!)
superstition -- суеверие, предрассудки
supper -- ужин
supplement -- добавление
supplied -- Снабженный (TR!)
supplies -- Запасы(поставки) (TR!)
supply -- снабжать
support -- поддерживать, опора, поддержка
supported -- Поддержанный (TR!)
supporter -- сторонник
supporting -- опорный -ing
suppose -- полагать, предполагать
supposed -- предполагаемый (от suppose)
supposedly -- предположительно
suppress -- подавлять
suppressed -- Подавленный (TR!)
supreme -- верховный, высший
sure -- уверенный, убедиться, безусловно
surely -- несомненно
surface -- поверхность
surfaces -- Поверхности (TR!)
surgeon -- хирург
surgery -- хирургия, приемная хирурга
surly -- угрюмый, неприветливый **r**
surname -- фамилия
surplus -- излишек
surprise -- удивление, удивлять
surprising -- удивительный
surprisingly -- удивительно
surround -- окружать
surrounding -- Окружение (TR!)
surroundings -- окрестности, среда, окружение
survey -- осмотр
surveyed -- Рассмотренный (TR!)
surveying -- Рассмотрение -ing (TR!)
survive -- пережить
susan -- Сьюзен (TR!)
suspect -- подозревать
suspected -- Подозреваемый (TR!)
suspend -- приостанавливать
suspended -- приостановленный !NEW!
suspense -- неизвестность
suspension -- приостановка, пауза, перерыв
suspicion -- подозрение
suspicions -- Подозрения (TR!)
suspicious -- подозрительный
sustain -- поддерживать (*u-)
swallow -- глотать, проглатывать
swam -- плавал (от swim)
swamp -- болото, топь s-
swan -- лебедь
swarm -- рой, толпа; роиться, толпиться (не crowd)
sway -- качание, взмах
swear -- клясться
sweat -- пот, потеть
sweater -- эксплуататор
sweep -- (под)мести s-
sweet -- милый, сладкий, приятный s-
sweetheart -- возлюбленный(ая), дорогой(ая) (как обращение)
sweetness -- Сладость (TR!)
swell -- отличный, превосходный
swelling -- воспаление, отек -ing
swept -- подметал !NEW!
swift -- быстрый (не speed)
swiftly -- быстро !NEW!
swig -- потягивать вино
swim -- плавать
swimmer -- пловец
swimming -- плавание
swindle -- обман, обманывать, надувать (не deceive)
swing -- качание, качели, качаться, колебаться
switch -- переключать, включать, выключатель, выключать
sword -- меч, шпага, сабля
syllable -- слог
symbol -- символ
sympathetic -- сочувственный
sympathize -- сочувствовать
sympathy -- симпатия, сострадание
syntax -- Синтаксис (TR!)
syringe -- шприц
system -- система
systems -- Системы (TR!)
tab -- петелька
table -- стол, таблица, расписание
tables -- Столы (TR!)
tablets -- таблетки (от tablet)
tack -- линия, курс (t-)
tackle -- хватать *a-
tactics -- тактика
tag -- бирка, ярлык
tail -- конец, хвост
take -- брать, взять, принимать
taking -- овладение
tale -- повесть, сказка, история
talent -- талант
talented -- талантливый
tales -- сказки, истории (от tale)
talk -- говорить, беседовать
talking -- беседа
tall -- невероятный, высокий
tally -- бирка, этикетка, дубликат, копия (не label)
tame -- приручать, приручить, прирученный
tangerine -- мандарин (плод)
tangible -- осязаемый
tangle -- сплетение, путаница, запутывать(ся)
tank -- танк, резервуар
tap -- постучать
tape -- лента, обматывать лентой
tar -- смола, деготь; мазать дегтем, смолить
target -- задание
task -- задача
taste -- пробовать, иметь вкус
tasted -- пробовал (от taste)
tastes -- имеет вкус (от taste)
taught -- обучал, обученный (от teach)
tax -- налог
taxi -- такси
tea -- чай, отвар
teach -- обучать, преподавать
teacher -- учитель
teaching -- обучение
team -- команда
teams -- команды (от team)
tear -- слеза, разрыв, (по)рвать
tearing -- Разрывание -ing (TR!)
tears -- слёзы !NEW!
tease -- дразнить, задира
technical -- технический
technician -- специалист t-
technique -- техника
ted -- раскидывать
teddy -- Тэдди (TR!)
tedious -- скучный, утомительный **d****
teenagers -- подростки (от teenager)
teeth -- зубы
telegram -- телеграмма
telegraph -- телеграф
telephone -- телефон, звонить по телефону
telescope -- телескоп
television -- телевидение
tell -- говорить, рассказывать
tells -- Сообщает (TR!)
temper -- сдержанность, самообладание
temperature -- температура
temple -- храм
temporarily -- временно
temporary -- временный
tempt -- искушать
temptation -- искушение, соблазн
tempted -- Соблазненный (TR!)
ten -- десять
tenant -- арендатор, жилец
tend -- иметь тенденцию
tendency -- тенденция
tender -- нежный t-
tenderly -- нежно, мягко !NEW!
tenderness -- нежность !NEW!
tennis -- теннис
tense -- время (грам.)
tent -- палатка
tentacles -- Щупальца (TR!)
tentative -- предварительный, предполагаемый; умозрительный, не вполне определенный
tenth -- десятый
term -- семестр, срок
terminal -- конечный пункт
terminate -- кончать(ся)
terminus -- Конечная остановка (TR!)
terms -- личные отношения, условия соглашения
terrace -- терраса
terrible -- ужасный, страшный
terribly -- ужасно t-
terrific -- потрясающий, ужасающий
terrified -- Испуганный (TR!)
territory -- территория
terror -- ужас t-
test -- анализ, проверка, испытывать
testing -- испытание
text -- текст
textbook -- учебник
than -- чем
thank -- благодарить
thankful -- благодарный
thanks -- спасибо
that -- это, тот, та, то
thaw -- оттепель
the -- определенный артикль
theatre -- театр
theatres -- театры (от theatre)
thee -- Вас (TR!)
theft -- кража t-
their -- их (на вопрос "чей?")
them -- их (на вопрос "кого?", "что?")
theme -- тема (не topic)
themselves -- себя, себе
then -- тогда, потом, затем
thence -- Отсюда (TR!)
theory -- теория
there -- там, туда, вот
thereafter -- после этого; впоследствии (не afterwards) !NEW!
thereby -- таким образом t-
therefore -- поэтому, следовательно
thereupon -- после чего, на что
these -- эти, это
they -- они
thick -- толстый, густой
thicket -- Чаща (TR!)
thief -- вор
thimble -- наперсток, наконечник
thin -- тонкий, худощавый
thing -- вещь, предмет
things -- вещи, дела (от thing)
think -- думать, мыслить
thinking -- размышление
thinks -- думает (от think)
third -- третий
thirst -- жажда
thirsty -- испытывающий жажду
thirteen -- тринадцать
thirteenth -- тринадцатый
thirty -- тридцать
this -- этот, это
thomas -- Томас (TR!)
thong -- ремень, плеть
thorn -- шип, колючка (не prick)
thorny -- колючий, тернистый ****n*
thorough -- тщательный
thoroughfare -- проход, проезд
thoroughly -- тщательно
thorpe -- Торп (TR!)
those -- тот, та, то, те
thou -- Вы (TR!)
though -- хотя, несмотря на
thought -- думал, обдуманный (от think), мысль
thoughtful -- задумчивый, погруженный в размышления
thoughtfully -- внимательно !NEW!
thoughtless -- необдуманный, беспечный, эгоистичный
thousand -- тысяча
thrash -- молотить, бить
thread -- нитка
threat -- угроза
threaten -- грозить, угрожать
threatened -- находящийся в угрожаемом положении !NEW!
threatening -- Угроза -ing (TR!)
three -- три
threshold -- порог
threw -- бросал (не flung) !NEW!
thrice -- трижды
thrill -- волновать
thrilled -- возбуждённый !NEW!
thrilling -- захватывающий -ing
thrive -- преуспевать; буйно, пышно расти
throat -- горло
throb -- пульсация, пульсировать
throbbing -- пульсация, биение
throne -- трон
throng -- толпиться, переполнять
through -- через, сквозь
throughout -- повсюду, везде, во всех отношениях (не everywhere)
throw -- бросать
thrust -- толчок, удар, толкать
thumb -- большой палец (руки)
thunder -- гром, греметь
Thursday -- четверг
thus -- так, таким образом
thy -- Ваш (TR!)
ticket -- билет
tickets -- билеты (от ticket)
tickle -- щекотать
tide -- прилив и отлив
tidy -- чистый, аккуратный, убирать, приводить в порядок
tidying -- уборка
tie -- связь, связывать, галстук
tied -- связанный !NEW!
ties -- связи (от tie)
tiger -- тигр
tight -- плотный, крепкий, тугой
tighten -- сжимать (не squeeze)
tile -- черепица, кафель
till -- до
tim -- Тим (TR!)
timber -- бревно
time -- время
timeout -- Перерыв (TR!)
times -- раз (от time)
timetable -- расписание
timid -- робкий, застенчивый
tin -- олово, жестянка, консервная банка
tinker -- Ремесленник (TR!)
tinkle -- звон, звяканье
tiny -- крошечный
tip -- чаевые, давать на "чай", наконечник
tips -- Наконечники(чаевые) (TR!)
tiptoe -- кончики пальцев, цыпочки
tire -- уставать, надоесть
tired -- усталый (от tire)
tiresome -- утомительный
tiring -- утомительный t-
title -- заглавие, титул
to -- предлог, частица инфинитива
toad -- жаба
toast -- тост (жар. хлеб), сушить
tobacco -- табак
today -- сегодня, теперь, современный
today's -- сегодняшний (от today)
toddle -- ковыляние, прогуливаться
toe -- палец
toes -- Пальцы ноги(носки) (TR!)
toffee -- ириска
together -- вместе, одновременно
toil -- трудиться, (тяжелый) труд
toilet -- туалет
token -- признак, примета
told -- рассказал, сообщил (от tell)
tolerable -- сносный, допустимый
tolerant -- терпимый (не bearable)
tolerate -- терпеть
tomato -- томат, помидор
tomatoes -- помидоры (от tomato)
tomb -- могила, гробница
tome -- Том (TR!)
tommy -- Томми (TR!)
tomorrow -- завтра, назавтра
ton -- тонна
tone -- стиль, характер
tones -- Тоны (TR!)
tongs -- щипцы, клещи
tongue -- язык
tonight -- сегодня вечером
too -- слишком, тоже
took -- брал (от take)
tool -- инструмент
tools -- инструменты !NEW!
tooth -- зуб
toothache -- зубная боль
top -- верх, верхушка
topic -- тема
topmost -- самый верхний, самый важный
topple -- валиться
torch -- факел
torches -- фонарики !NEW!
tore -- рвал !NEW!
torn -- оборванный (не worn) !NEW!
torrent -- поток
tortoise -- черепаха
torture -- пытать, пытка (не attempt)
toss -- толчок, сотрясение, кидать, бросать
total -- сумма, весь, полный t-
totally -- полностью
touch -- соприкосновение, контакт
touching -- трогательный -ing
tough -- жесткий
tour -- путешествие, тур (не trip)
tourist -- турист(ский)
tournament -- турнир
tow -- буксировать, тянуть, тащить
toward -- к, на
towards -- к, в направлении
towel -- полотенце
tower -- башня
towers -- Башни (TR!)
town -- город (не city)
towns -- Города (TR!)
toy -- игрушка, играть, забавляться
toys -- игрушки (от toy)
trace -- следить, чертить
traced -- Прослеженный (TR!)
traces -- Следы (TR!)
track -- след, тропа, колея
tracks -- Следы (TR!)
trade -- торговать, ремесло, занятие, профессия
trading -- торговля
traditional -- традиционный
traditionally -- традиционно
traffic -- уличное движение
tragedy -- трагедия
tragic -- трагический
trail -- след (не trace)
trailer -- прицеп к автомобилю
train -- поезд, привлекать, воспитывать
trained -- обученный
trainer -- тренер
training -- тренировка, обучение
trains -- поезда (от train)
traitor -- изменник, предатель
tram -- трамвай
tramp -- бродить, громко топать, бродяга
tranquilizer -- Транквилизатор (TR!)
transaction -- дело, сделка, ведение (дел), труды, протоколы (общества) t-
transactions -- Сделки (TR!)
transfer -- передача, переносить
transformation -- преобразование
translate -- переводить, объяснять
translating -- перевести (от translate)
translation -- перевод
transmission -- передача
transmitted -- Переданный (TR!)
transparent -- прозрачный
transport -- транспорт, перевозить
transportation -- перевозка
trap -- ловушка, западня
trapdoor -- люк
trapes -- Западни t- (TR!)
travel -- путешествовать
travelled -- путешествовал, много путешествовавший (от travel)
traveller -- путешественник
travelling -- путешествие, путешествующий -ing
travels -- Путешествия (TR!)
traverse -- пересекать
tray -- поднос
treacherous -- предательский, вероломный
tread -- ступать, наступать
treasure -- сокровище
treasurer -- Казначей (TR!)
treasures -- Сокровища (TR!)
treasury -- сокровищница
treat -- удовольствие, лечить, относиться
treated -- лечил (от treat)
treatment -- обращение, обработка
tree -- дерево (tree)
trek -- поход, переход (не pass)
tremble -- дрожать, дрожь
tremendous -- громадный, значительный t-
trend -- общее направление, тенденция
trespass -- преступать, нарушать границу (владения)
trial -- попытка, испытание
trials -- Испытания(суды) (TR!)
tribe -- племя, клан
tribute -- дань
trice -- мгновение
trick -- хитрость, обман, обманывать (t-)
tried -- пытался (от try)
trifle -- пустяк
trifling -- Пустяковый -ing (TR!)
trigger -- курок
triggers -- Спусковые механизмы (TR!)
trim -- подрезка, стрижка t-
trip -- поездка, экскурсия
triple -- тройной
trips -- поездки (от trip)
triumph -- триумф
triumphal -- триумфальный
triumphant -- торжествующий, победоносный
trolley -- тележка
troop -- войска
troops -- войска
trophy -- трофей
tropical -- тропический
trot -- рысь, рысца, бежать рысью
trouble -- неприятность, беда, беспокоить(ся), волноваться
troubled -- побеспокоил (от trouble)
troubles -- неприятности (от trouble)
troublesome -- трудный, неприятный, капризный (о ребенке)
trousers -- брюки
trout -- форель
truck -- грузовик t-
true -- правильный, верный
truly -- точно, правдиво, истинно, верно
trumpet -- труба t-
trunk -- ствол, туловище
trust -- доверять, доверие, вера
trusted -- Доверял (TR!)
truth -- правда, истина
truthful -- правдивый
try -- пробовать, пытаться
trying -- ищу (место, адрес) (от to try for)
tub -- кадка, лохань, ушат
tube -- труба (не pipe)
tucked -- Подвернутый (TR!)
Tuesday -- вторник
tumble -- падать, опрокидываться
tumbled -- Кувыркался (TR!)
tumbler -- Тумблер (TR!)
tune -- мотив
tunnel -- тоннель
turf -- дерн
turk -- Турок (TR!)
turkey -- индейка
turn -- поворачивать, вращать, оборот, поворот, очередь
turner -- токарь
turnip -- репа
turnstile -- Турникет (TR!)
turpentine -- скипидар
turtle -- Черепаха (TR!)
TV -- телевизор, телевидение
twelfth -- двенадцатый
twelve -- двенадцать
twentieth -- двадцатый
twenty -- двадцать
twice -- дважды, вдвое
twig -- веточка, прутик
twilight -- сумерки t-
twin -- двойной, двойник, близнец
twinkle -- мерцать, сверкать, мигать, мелькать
twins -- близнецы
twist -- вить(ся), крутить, скручивать
twisted -- искривленный t-
twit -- упрек, насмешка (не mock)
two -- два
type -- тип, род t-
types -- Типы (TR!)
typewriter -- пишущая машинка
typical -- типичный
tyre -- шина
ugly -- уродливый
ultimate -- последний
ultimately -- В конечном счете (TR!)
umbrella -- зонт
un -- ООН (TR!)
unable -- неспособный
unanimous -- единодушный, единогласный
unanimously -- единодушно
unaware -- незнающий
uncertain -- неясный (не от слова clear)
unchanged -- неизменившийся
uncle -- дядя
uncomfortable -- неудобный u-
uncommon -- неординарный
unconscious -- бессознательный
under -- под
undergo -- испытывать, подвергаться
undergone -- Подвергнемся (TR!)
underground -- метрополитен, подземный, подпольный
underline -- подчеркивать
underneath -- вниз, внизу, под
understand -- понимать, подразумевать
understanding -- понимание, способность понять
understood -- понимал, понятый (от understand)
undertake -- предпринимать
undertaking -- предприятие
underwater -- Под водой (TR!)
underwear -- нижнее белье
undesirable -- нежелательный
undo -- развязывать, расстегивать
undoubtedly -- несомненно
undress -- раздеваться
uneasiness -- тревога, неловкость
uneasy -- встревоженный, неловкий
unexpected -- неожиданный
unfair -- несправедливый
unfinished -- незаконченный
unfit -- негодный, неподходящий
unfortunate -- несчастный человек, горемыка u-
unfortunately -- к несчастью, к сожалению
ungrateful -- неблагодарный u-
unhappy -- несчастный, неудачный (unhappy)
uniform -- форма, форменная одежда
union -- союз
unions -- союзы (от union)
unique -- Уникальный (TR!)
unit -- единица
unite -- соединять(ся)
united -- объединенный
units -- единицы (от unit)
unity -- единство
universal -- всеобщий
universe -- мир, вселенная
University -- университет
unkind -- недобрый
unknown -- неизвестный
unleash -- развязывать (войну)
unless -- если не, пока не
unlike -- непохожий
unlikely -- маловероятный, вряд ли
unlimited -- неограниченный (не boundless)
unload -- разгружать(ся), разряжать (оружие)
unlock -- отпирать
unlucky -- неудачный
unmoved -- равнодушный
unnatural -- неестественный, противоестественный
unnecessary -- ненужный
unofficial -- неофициальный
unpleasant -- неприятный
unpredictable -- непредсказуемый u-
unreasonable -- неразумный, неблагоразумный
unregistered -- Незарегистрированный (TR!)
unresolved -- нерешенный
unrest -- беспокойство (не bother, harass)
unseen -- Невидимый (TR!)
unskilled -- неквалифицированный
unsuccessful -- неудачный
untidy -- неаккуратный
until -- до
unusual -- необычный
unusually -- необычно
unwelcome -- нежеланный, неприятный
unwilling -- несклонный, нерасположенный
unwise -- неразумный
unworthy -- недостойный
up -- вверх, до предела, наверху
update -- Модернизация (TR!)
updated -- Обновленный (TR!)
upgrade -- Модернизировать (TR!)
upon -- на
upper -- верхний
upright -- прямой, вертикальный, честный, справедливый u-
uproar -- шум, волнение (не shindy)
upset -- беспорядок, расстройство, расстроенный
upstairs -- наверху
upward -- направленный вверх
upwards -- вверх
urban -- городской
urge -- понуждать
urged -- Побуждённый, подстёгнутый (TR!)
urgent -- крайне необходимый, срочный
urgently -- срочно
urn -- урна
us -- нас, нам
usage -- употребление, обычай
use -- использовать, употребить, польза, применение
used -- использованный, подержанный (от use)
useful -- полезный
usefully -- с пользой
useless -- бесполезный
user -- потребитель
users -- Пользователи (TR!)
using -- пользование
usual -- обыкновенный, обычный
usually -- обычно, обыкновенно
utilities -- Предприятия коммунального обслуживания (TR!)
utility -- полезность, выгодность, удобства, коммунальные услуги u-
utilize -- использовать
utmost -- крайний u-
utter -- издавать (звук), произносить
uttered -- Произнесенный (TR!)
utterly -- совершенно (не perfect, totally)
vacant -- свободный, незанятый
vacation -- отпуск, каникулы
vaccination -- прививка
vague -- неопределенный, смутный
vaguely -- Неопределенно (TR!)
vain -- напрасный, тщетный
vale -- прощание
valiant -- храбрый, мужественный (не от слова brave)
valid -- правильный v-
valley -- долина
valleys -- Долины (TR!)
valuable -- ценный, дорогой
valuation -- оценка
value -- ценность, цена, дорожить, ценить
valued -- Оцененный (TR!)
valuer -- оценщик
values -- Ценности (TR!)
valve -- клапан, створка, радио электронная лампа
van -- фургон, багажный вагон
vanish -- исчезать, пропадать
vanished -- Исчез (TR!)
vanity -- тщеславие
vapour -- пар, пары
variability -- Изменчивость (TR!)
variable -- изменчивый, непостоянный
variables -- Переменные (TR!)
variation -- Изменение(разновидность) (TR!)
variations -- Изменения(разновидности) (TR!)
varied -- Различный (не differ) (TR!)
varieties -- Множества (TR!)
variety -- разнообразие
various -- различный, разный
varnish -- лак, лоск, лакировать
vary -- отличаться, расходиться
varying -- Изменение -ing (TR!)
vase -- ваза
vast -- обширный, громадный
vastly -- значительно
vault -- свод
veal -- телятина
vegetable -- овощ, растение, овощной
vegetables -- овощи (от vegetable)
vegetation -- Растительность (TR!)
vehemently -- сильно v-
vehicle -- транспортное средство
veil -- завеса, покрывало
vein -- вена, жила, жилка
velvet -- бархат, преимущество
veneering -- Облицовывание -ing (TR!)
vengeance -- месть, мщение
vent -- выпускать, испускать
venture -- предприятие, риск
ventures -- предприятия (от venture)
venus -- Венера (TR!)
verandah -- Веранда (TR!)
verdure -- зелень ***d***
verge -- грань, край
verify -- проверять, подтверждать
vernon -- Вернон (TR!)
verse -- стихи, поэзия
version -- версия
versions -- Версии (TR!)
vertical -- вертикальный
vertically -- Вертикально (TR!)
very -- очень, тот самый
vessel -- сосуд, судно
vest -- жилет (амер.), майка
veteran -- ветеран
vex -- раздражать, сердить
vexation -- досада, раздражение (не nuisance)
vexed -- сердил, раздражал (от vex)
via -- через
vice -- порок
vicinity -- окрестности, соседство, близость
vicious -- порочный
victim -- жертва
victorious -- победоносный
victory -- победа
view -- взгляд, мнение, осматривать
viewed -- Рассматриваемый (TR!)
viewpoint -- точка зрения
views -- Представления(виды) (TR!)
vigilance -- бдительность
vigorous -- сильный v-
vigorously -- энергично !NEW!
vigour -- сила, энергия v-
village -- деревня
villager -- сельский житель
villain -- злодей, негодяй
vine -- виноградная лоза
vinegar -- уксус
violence -- сила, неистовство, насилие
violent -- яростный v-
violently -- неистово v-
violet -- фиолетовый (не purple)
virtual -- фактический
virtue -- добродетель
viscount -- Виконт (TR!)
visible -- видимый, очевидный
vision -- зрение, видение
visit -- визит, посещать, навещать
visited -- посетил (от visit)
visiting -- приезжий -ing
visitor -- гость
visits -- Посещения (TR!)
visual -- зрительный, наглядный
vital -- жизненный, крайне необходимый
vivid -- живой, яркий
vocation -- призвание
voice -- голос
void -- лишенный, недействительный (юр.)
volcano -- вулкан
volume -- объем, громкость
voluntary -- добровольный
vote -- голос (на выборах), голосование, голосовать
vow -- обет, клятва
voyage -- путешествие v-
wad -- прокладывать
wade -- пробираться, продираться
wag -- махать, трясти
wage -- заработная плата
wager -- держать пари, рисковать
waggoner -- Извозчик (TR!)
wagon -- повозка !NEW!
wail -- вопль, вой, вопить, выть
wailed -- Вопил (TR!)
wailing -- Вопящий -ing (TR!)
waist -- талия
waistcoat -- жилет
wait -- ждать, ожидать, ожидание
waited -- ждал (от wait)
waiter -- официант
waiting -- ждать (от to keep waiting)
waitress -- официантка
wake -- будить, просыпаться
walk -- гулять, ходить пешком (не hike)
walked -- гулял (от walk)
walking -- гуляющий
wall -- стена
wallace -- Уоллис (TR!)
wallet -- бумажник
wallpaper -- обои
walnut -- грецкий орех
walrus -- морж
walter -- Уолтер (TR!)
wan -- бледный, изнуренный
wand -- Палочка (TR!)
wander -- бродить, блуждать
wanderer -- странник (не stranger)
wandering -- блуждание !NEW!
want -- хотеть, желать, нуждаться в
wanted -- хотел, желанный (от want)
wanting -- Желание (TR!)
wants -- хочет, желает, нуждается в (от want)
war -- война, воевать
ward -- опека
wardrobe -- гардероб
warehouse -- склад, пакгауз
warily -- осторожно
warm -- теплый, согревать
warmly -- тепло (-- как? -- тепло!) !NEW!
warmth -- тепло, теплота, сердечность
warn -- предупреждать w-
warning -- предупреждение
warrant -- полномочие, ордер, гарантировать
warrior -- воин (w-)
warriors -- Воины (TR!)
wars -- Войны (TR!)
wary -- осторожный
was -- был (от be)
wash -- мыть, стирать, мытье, стирка
washed -- мыл, вымытый (от wash)
wasp -- оса
waspish -- злой, раздражительный (не vicious)
waste -- тратить, использованный, негодный
wasted -- Потраченный впустую (TR!)
wasteful -- расточительный
watch -- часы, cмотреть, наблюдать
watcher -- сторож, наблюдатель
watches -- часы (от watch)
watchful -- бдительный (не vigilant)
watching -- просмотр
watchman -- (ночной) сторож
water -- вода, поливать, разбавлять
waterproof -- непромокаемый, непромокаемый плащ
watery -- водянистый, дождевой, бесцветный
wave -- волна
waved -- Махал (TR!)
waver -- колебаться, быть в нерешительности
waving -- Помахивание (TR!)
wavy -- волнистый, бурный
wax -- воск, восковой
waxworks -- Восковые фигуры (TR!)
way -- дорога, путь, способ
wayfarer -- путник, пешеход
we -- мы
weak -- слабый
weakness -- слабость
wealth -- богатство
wealthy -- богатый (w-)
weapon -- оружие
weapons -- Оружие (TR!)
wear -- одежда, носить, быть одетым
weariness -- усталость
wearisome -- скучный, надоедливый
weary -- усталый, утомительный, утомлять(ся), устать, потерять терпение
weather -- погода
weave -- ткать, плести
web -- ткань, лента, перемычка
wedding -- свадьба, венчание
wedge -- клин
Wednesday -- среда
weed -- сорняк, полоть
week -- неделя
weekend -- выходные
weekly -- еженедельный, еженедельно
weep -- плакать
weeping -- Плач *e-ing (TR!)
weigh -- взвешивать, весить
weight -- вес, тяжесть, груз
weighty -- веский
weird -- судьба, рок, таинственный, странный
welcome -- желанный, гостеприимство
welfare -- благосостояние
well -- хорошо, очень, добро, здоровый (не good)
went -- шел, ехал (от go)
wept -- Плакал (TR!)
were -- были (от be)
West -- запад
western -- западный
wet -- мокрый
whale -- кит
what -- что, какой
whatever -- что бы ни
wheat -- пшеница
wheel -- колесо
wheelbarrow -- тачка
wheeled -- Колесный (TR!)
wheels -- Колеса (TR!)
when -- когда
whence -- Откуда (TR!)
whenever -- когда бы ни
where -- где, куда
whereas -- тогда как, принимая во внимание
whereby -- чем, при помощи
whereupon -- после чего, сразу после; немедленно после
wherever -- где бы ни, куда бы ни
whether -- ли
which -- который
while -- пока, в то время как, тогда как
whilst -- Пока (TR!)
whine -- визг, скулить
whip -- кнут, хлыст, хлестать, сечь, взбивать (сливки, яйца)
whirl -- вихрь
whirlwind -- вихрь
whiskers -- бакенбарды, усы (у животных)
whisper -- шепот, шептать
whispering -- Шептание (TR!)
whistle -- свист, свистеть
whistled -- Свистел (TR!)
whistling -- Свист (TR!)
white -- белый
who -- кто
whoever -- кто бы ни
whole -- целый, весь, целое
wholesome -- полезный, здоровый, благотворный
wholly -- полностью
whom -- кому, кого
whose -- чей
why -- почему
wicked -- злой
wide -- широкий
widely -- широко
widen -- расширять(ся)
widow -- вдова
width -- ширина
wife -- жена
wig -- парик
wild -- исступленный, безумный
wilderness -- пустыня, глушь
wildly -- Дико (TR!)
Wilfrid -- Вилфрид !NEW!
will -- вспомогательный глагол будущего времени
william -- Уильям (TR!)
willing -- готовый, охотно делающий что-либо
willingly -- охотно
willow -- ива
win -- выигрывать, побеждать
wind -- ветер, виток, виться, наматывать
windfall -- неожиданная удача
winding -- изгиб w- -ing
window -- окно, оконный
windows -- окна (от window)
winds -- Ветры (TR!)
windy -- ветреный
wine -- вино, винный, пить вино
wing -- крыло
wings -- крылья !NEW!
wink -- моргать, мигать, моргание, мигание
winner -- победитель
winning -- выигрывающий, победа (-ing)
winter -- зима
wipe -- вытирать
wiped -- Вытертый (TR!)
wire -- переводить телеграфом (деньги)
wireless -- беспроволочный, радио
wisdom -- мудрость
wise -- мудрый
wisely -- мудро
wish -- желание, желать
wishes -- пожелания (от wish)
wishing -- Пожелание -ing (TR!)
wit -- ум, остроумие, остроумный человек, остряк
with -- с
withdraw -- брать назад, забирать
withdrew -- Отошел (TR!)
within -- внутри, внутрь (w-)
without -- без
witness -- свидетель
witnessed -- Засвидетельствованный (TR!)
wits -- Остроумие (TR!)
wizard -- колдун, специалист своего дела !NEW!
wizards -- Волшебники (TR!)
woke -- будил (от wake)
woken -- разбуженный (от wake)
wolf -- волк
wolves -- Волки (TR!)
woman -- женщина
women -- женщины (от woman)
won -- победил, побежденный (от win)
wonder -- удивляться
wonderful -- замечательный, чудесный
wonderfully -- Чудесно w- TR!)
wondering -- удивляющийся, интересующийся (-ing) !NEW!
wood -- лес, древесина, дрова
wooden -- деревянный
woodland -- лесистая местность
woodlands -- Лесистые местности (TR!)
wool -- шерсть
woollen -- шерстяной
word -- слово, обещание
wording -- редакция, форма выражения, формулировка -ing
words -- слова (от word)
wore -- носил, изнашивал (w-) !NEW!
work -- работать, делать, работа, труд
worked -- работал, сработанный (от work)
worker -- рабочий
working -- делающий, творящий (от work)
workman -- рабочий (мужик)
workroom -- Рабочее помещение (TR!)
workshop -- мастерская
world -- мир, свет
worlds -- Миры (TR!)
worm -- червь, глист, ничтожество (перен.)
worn -- потёртый, изношенный !NEW!
worry -- беспокоиться
worse -- хуже (от bad)
worship -- поклоняться (не regards)
worst -- наихудший
worth -- стоящий, заслуживающий
worthless -- ничего не стоящий, дрянной
worthy -- достойный
would -- вспомогательный, модальный глагол (от will)
wound -- рана
wounded -- раненый
wow -- Ничего себе (TR!)
wrap -- завертывать, шаль, плед, обертка
wrath -- гнев, ярость
wreck -- крушение (w-)
wren -- Крапивник (TR!)
wrestle -- бороться
wretch -- несчастный, негодяй
wretched -- несчастный, жалкий
wring -- скручивать, выжимать
wrinkle -- морщина, морщить(ся)
wrist -- наручный, запястье
write -- писать, записывать
writer -- писатель
writing -- письменность (-ing)
written -- письменный, написанный
wrong -- неправильный, не тот
wrote -- писал, написанный (от write)
yacht -- яхта
yard -- ярд, двор
yawn -- зевать, зевота
ye -- Вы (TR!)
yeah -- да !NEW!
year -- год
yearling -- козленок, ягненок
yell -- пронзительный крик, кричать, вопить
yellow -- желтый
yes -- да
yesterday -- вчера
yet -- однако, еще
yield -- приносить y-
yielded -- Выданный (TR!)
yielding -- Выдающий(уступающий) -ing (TR!)
yoke -- иго, ярмо
yonder -- вон тот !NEW!
you -- вы, ты
young -- молодой
younger -- моложе (от young)
youngest -- самый молодой, младший (от young)
youngster -- юноша
your -- ваш, твой
yours -- ваш, ваши, твой, твои
yourself -- сам, сами
yourselves -- Самостоятельно (TR!)
youth -- молодежь
youthful -- юный, юношеский y-
yuri -- Юрий (TR!)
zeal -- усердие, рвение
zero -- ноль
zigzag -- Зигзаг (TR!)
zinc -- цинк, цинковый, оцинковывать
zone -- зона
zoo -- зоопарк
zoological -- Зоологический (TR!)
hunter -- охотник
hunting -- охота
hurricane -- ураган h-
hurried -- спешил, торопился (от hurry)
hurriedly -- поспешно !NEW!
hurry -- спешить, торопиться, спешка
hurt -- рана, болеть, причинить боль, повредить
hurts -- болеет, причиняет боль, повреждает (от hurt)
husband -- муж
hush -- водворять тишину
hut -- хижина
hybrid -- Гибрид (TR!)
hybrids -- Гибриды (TR!)
hygienic -- гигиенический
hypothesis -- Гипотеза (TR!)
hysteria -- истерия
hysterical -- истерический
I -- я
ice -- лед
icebox -- холодильник (морозильник) (не fridge)
icicle -- сосулька
icy -- ледяной
idea -- идея, мысль
ideal -- идеал, идеальный
identical -- тождественный
identification -- отождествление
identifier -- Идентификатор (TR!)
identifiers -- Идентификаторы (TR!)
identify -- опознавать, распознавать; устанавливать личность
idiot -- идиот
idle -- бесполезный
if -- если
ignition -- зажигание, воспламенение
ignorance -- незнание, невежество
ignorant -- невежественный, неосведомленный, несведущий
ignore -- игнорировать
ill -- больной
illegal -- нелегальный
illiterate -- неграмотный
illness -- болезнь
illuminate -- освещать
illuminated -- Освещенный (TR!)
illumination -- освещение
illusion -- иллюзия
illustration -- Иллюстрация (TR!)
image -- изображение, образ, имидж
imagination -- воображение
imagine -- думать, воображать
imitate -- подражать
imitation -- подражание, имитация
immediate -- непосредственный
immediately -- немедленно
immense -- громадный, необъятный
immensely -- чрезвычайно i-
immersed -- Погруженный (TR!)
imminent -- надвигающийся
immortal -- бессмертный
impact -- удар (не stroke)
impatience -- нетерпение
impatient -- нетерпеливый
impatiently -- нетерпеливо
impediment -- препятствие
impenetrable -- непроницаемый
imperative -- повелительное наклонение (грам.)
imperfect -- несовершенный
imperial -- Имперский (TR!)
impertinence -- дерзость
implement -- выполнять
implementation -- Выполнение (TR!)
implemented -- Осуществленный (TR!)
implied -- подразумеваемый (i-)
impolite -- невежливый, неучтивый
import -- импорт, ввоз
importance -- важность
important -- важный
impose -- налагать
impossible -- невозможный
impostor -- самозванец, плут
impress -- производить впечатление
impression -- впечатление
impressive -- впечатляющий -ve
imprison -- заключать в тюрьму
improbable -- невероятный
improve -- улучшать
improved -- улучшил (от improve)
improvement -- улучшение
improvements -- Усовершенствования (TR!)
impulse -- побуждение, порыв
impure -- нечистый, грязный, с примесью
in -- в
inability -- неспособность
inaccessible -- недоступный
incessant -- непрерывный, вечный
inch -- дюйм
inches -- Дюймы (TR!)
incident -- инцидент
incidentally -- между прочим
inclination -- склонность
incline -- склонять
inclined -- наклонный
include -- включать
included -- включенный (от include)
including -- включая
inclusion -- включение
income -- доход, заработок
incomprehensible -- непонятный, непостижимый i-
inconsistent -- непоследовательный
inconvenient -- неудобный
incorrect -- неверный, неправильный
increase -- рост
increasing -- возрастающий
increasingly -- все больше и больше
incredible -- невероятно
incur -- подвергаться
indebted -- обязанный
indeed -- неужели, действительно (не really)
indefinite -- неопределенный, неограниченный
independence -- независимость
independent -- независимый
independently -- независимо
index -- индекс, указатель, показатель
indexes -- Индексы (TR!)
indians -- Индусы(индейцы) (TR!)
indicate -- показывать, указывать
indices -- Индексы (не indexes) (TR!)
indifference -- безразличие
indifferent -- безразличный
indigenous -- местный
indigestion -- несварение, расстройство
indignant -- негодующий, возмущенный
indignation -- негодование, возмущение
indirect -- косвенный
individual -- личность, индивидуальный
indolent -- ленивый, праздный, безболезненный
indoors -- в помещении
induce -- убеждать
induced -- Вынужденный(вызванный) (TR!)
industrial -- промышленный
industrious -- трудолюбивый, прилежный (не hardworking)
industry -- промышленность
ineffective -- неэффективный
inevitable -- неизбежный
infant -- младенец
infer -- заключать, делать вывод
inferior -- худший, плохой
infinite -- безграничный, бесконечный
infinitely -- бесконечно
inflected -- Склоняемый (TR!)
inflection -- Сгибание (TR!)
inflict -- наносить удар
influence -- влияние, влиять
influenced -- влиял (от influence)
info -- Информация (TR!)
inform -- сообщать
information -- информация
informed -- осведомленный
informs -- Сообщает (TR!)
inga -- Инга (TR!)
ingenious -- изобретательный, остроумный, находчивый
ingratitude -- неблагодарность
ingredient -- составная часть
inhabit -- жить, обитать
inhabitant -- житель
inhabitants -- Жители (TR!)
inhabited -- Населенный *n- (TR!)
inhale -- вдыхать
inherent -- неотъемлемый, присущий, свойственный (не Integral)
inherit -- (у)наследовать
inheritance -- наследство
inherited -- Унаследованный (TR!)
initial -- начальный, первоначальный
initially -- вначале i-
initiate -- начинать (не commence)
inject -- впрыскивать
injunction -- предписание
injure -- ушибиться -e
injured -- поврежденный i-
injury -- телесное повреждение
injustice -- несправедливость
ink -- чернила
inland -- внутренний
inn -- гостиница, постоялый двор
inner -- внутренний
innocence -- невинность, невиновность
innocent -- наивный, невинный
innumerable -- бесчисленный
input -- Вход (TR!)
inquire -- спрашивать, узнавать
inquired -- осведомлённый (не informed) !NEW!
inquiries -- справочное (от inquiry)
inquiry -- расспросы, наведение справок
inquisitive -- любопытный
insane -- душевнобольной, ненормальный
inscription -- надпись
insect -- насекомое
insects -- Насекомые (TR!)
insecure -- ненадежный, небезопасный (insecure)
insert -- вставлять, помещать (в газете)
inside -- внутрь, внутри
insignificant -- незначительный, ничтожный
insist -- настаивать
insolent -- наглый, дерзкий, оскорбительный
inspect -- осматривать, инспектировать
inspection -- осмотр
inspector -- контролер, инспектор i-
inspiration -- вдохновение
inspired -- Вдохновленный (TR!)
install -- водворять, устраивать, устанавливать
installation -- Установка (TR!)
installed -- Установленный (TR!)
installer -- Монтажник (TR!)
installing -- Монтаж -ing (TR!)
installs -- Устанавливает (TR!)
instance -- пример
instances -- Случаи *n- (TR!)
instant -- мгновение
instantly -- немедленно
instead -- вместо, взамен
instinct -- инстинкт
instinctive -- инстинктивный
institution -- учреждение
instruct -- инструктировать
instruction -- инструкция
instructor -- инструктор
instrument -- инструмент
insufficient -- недостаточный
insult -- оскорбление
insurance -- страхование, страховка
intake -- поглощение
integer -- Целое число (TR!)
integral -- неотъемлемый
intellectual -- интеллигент
intelligence -- интеллект
intelligent -- умный
intend -- намереваться
intended -- предполагаемый i-
intense -- интенсивный, напряженный
intent -- намерение, цель i-
intention -- намерение, замысел
intentional -- умышленный
intentions -- Намерения (TR!)
inspection -- осмотр
inspector -- контролер, инспектор i-
inspiration -- вдохновение
inspired -- Вдохновленный (TR!)
install -- водворять, устраивать, устанавливать
installation -- Установка (TR!)
installed -- Установленный (TR!)
installer -- Монтажник (TR!)
installing -- Монтаж -ing (TR!)
installs -- Устанавливает (TR!)
instance -- пример
instances -- Случаи *n- (TR!)
instant -- мгновение
instantly -- немедленно
instead -- вместо, взамен
instinct -- инстинкт
instinctive -- инстинктивный
institution -- учреждение
instruct -- инструктировать
instruction -- инструкция
instructor -- инструктор
instrument -- инструмент
insufficient -- недостаточный
insult -- оскорбление
insurance -- страхование, страховка
intake -- поглощение
integer -- Целое число (TR!)
integral -- неотъемлемый
intellectual -- интеллигент
intelligence -- интеллект
intelligent -- умный
intend -- намереваться
intended -- предполагаемый i-
intense -- интенсивный, напряженный
intent -- намерение, цель i-
intention -- намерение, замысел
intentional -- умышленный
intentions -- Намерения (TR!)
wrong -- неправильный, не тот
wrote -- писал, написанный (от write)
yacht -- яхта
yard -- ярд, двор
yawn -- зевать, зевота
ye -- Вы (TR!)
yeah -- да !NEW!
year -- год
yearling -- козленок, ягненок
yell -- пронзительный крик, кричать, вопить
yellow -- желтый
yes -- да
yesterday -- вчера
yet -- однако, еще
yield -- приносить y-
yielded -- Выданный (TR!)
yielding -- Выдающий(уступающий) -ing (TR!)
yoke -- иго, ярмо
yonder -- вон тот !NEW!
you -- вы, ты
young -- молодой
younger -- моложе (от young)
youngest -- самый молодой, младший (от young)
youngster -- юноша
your -- ваш, твой
yours -- ваш, ваши, твой, твои
yourself -- сам, сами
yourselves -- Самостоятельно (TR!)
youth -- молодежь
youthful -- юный, юношеский y-
yuri -- Юрий (TR!)
zeal -- усердие, рвение
zero -- ноль
zigzag -- Зигзаг (TR!)
zinc -- цинк, цинковый, оцинковывать
zone -- зона
statute -- закон, устав
stay -- оставаться, жить (временно)
stayed -- остался (от stay)
staying -- остающийся, живущий (от stay)
steadily -- неуклонно
steady -- прочный
steak -- бифштекс
steal -- (с)воровать
stealing -- Кража (TR!)
steam -- пар
steel -- сталь
steep -- крутой (не sharp)
steer -- править (рулём)
stem -- стержень
stems -- Стебли (TR!)
step -- шаг, шагать (step)
stepfather -- отчим
stephen -- Стивен (TR!)
sterile -- бесплодный !NEW!
sterility -- Бесплодие (TR!)
stern -- строгий
sternly -- строго !NEW!
steve -- Стив (TR!)
stew -- тушеное мясо
stick -- палка, приставать
sticking -- торчащий, приклеенный (-ing) !NEW!
sticks -- Палки (TR!)
sticky -- липкий, клейкий
stiff -- негнущийся, застывший, холодный, натянутый
stiffen -- (о)коченеть, (о)деревенеть
still -- все еще, однако, тихий
stir -- суета, суматоха, мешать, помешивать, волновать
stitch -- стежок, петля (в вязании), шить
stock -- запас, снабжать (не spare, hoard)
stocking -- чулок
stockings -- чулки (от stocking)
stocks -- Акции(запасы) (TR!)
stocky -- коренастый, низкий, приземистый !NEW!
stolen -- украденный (от steal)
stomach -- живот, желудок
stone -- камень
stool -- табуретка
stoop -- наклонять(ся), нагибать(ся), сутулиться, горбиться
stooped -- Наклоненный (TR!)
stop -- остановка, перестать, остановиться
stoppage -- остановка, задержка
stopped -- остановились (от stop)
stopper -- пробка, затычка
stops -- остановки (от stop)
storage -- хранение *t-
store -- магазин, имущество, запасать, снабжать
stored -- Запасенный (TR!)
storey -- этаж
stories -- истории, рассказы (от story)
stork -- аист
storm -- буря, взрыв (не blast)
stormy -- бурный
story -- рассказ, история
stout -- тучный, дородный
stove -- печь, плита
straight -- прямо, сразу, прямой, достоверный s-
straighten -- выпрямлять(ся)
straightened -- Выправляемый (TR!)
straightforward -- прямой
strain -- натягивать, напрягать(ся), напряжение
strait -- узкий, пролив, затруднительное материальное положение, нужда
strange -- странный
strangely -- странным образом
stranger -- незнакомец, иностранец
strangers -- Незнакомцы (TR!)
strangle -- задушить
strap -- ремень, стягивать ремнем
strategy -- стратегия
straw -- пустяк, мелочь
strawberries -- клубника
strawberry -- земляника
stray -- сбиваться с пути, заблудившийся
stream -- ручей, поток
street -- улица
strength -- численность, сила, прочность
strengthen -- усиливать, укреплять
stretch -- растягивать, вытягиваться
stretched -- растянутый !NEW!
stretching -- Протяжение (TR!)
strict -- точный
strictly -- строго *t-
strike -- ударять, забастовка
striking -- бьющий, ударяющий (от strike)
string -- вереница, ряд, струна, связывать
strings -- Вереницы(нити) (не threads) (TR!)
strip -- полоса
striped -- полосатый
stripes -- Полосы (TR!)
strode -- походка, большой шаг (прошедшее время) !NEW!
stroke -- удар, гладить *t
stroll -- прогулка, гулять
strong -- сильный
strongest -- Самый сильный (TR!)
stronghold -- крепость, оплот
strongly -- решительно (первая буква НЕ "d")
struck -- забастовка, удар (прошедшее время) !NEW!
structure -- структура
struggle -- бороться, борьба
struggling -- Борьба (TR!)
stubborn -- упрямый
stuck -- воткнул, приклеил !NEW!
stud -- запонка
student -- студент
students -- студенты (от student)
studied -- учился (от study)
studio -- студия
studious -- прилежный s-
study -- учиться, изучать, заниматься, исследование, кабинет
studying -- занимается (от study)
stuff -- вещество, материал, заполнять, набивать
stuffed -- Наполненный (TR!)
structure -- структура
struggle -- бороться, борьба
struggling -- Борьба (TR!)
stubborn -- упрямый
structure -- структура
struggle -- бороться, борьба
struggling -- Борьба (TR!)
stubborn -- упрямый
